table_id,row_id,_b_institution_b_full_path,_b_institution_b_level_1,_b_institution_b_level_2,_b_institution_b_hierarchy_depth,field_all_doctoral_students_rank,field_all_doctoral_students_total,field_all_doctoral_students_science,field_all_doctoral_students_engineering,field_all_doctoral_students_health,field_full_time_doctoral_students_rank,field_full_time_doctoral_students_total,field_full_time_doctoral_students_science,field_full_time_doctoral_students_engineering,field_full_time_doctoral_students_health,field_part_time_doctoral_students_rank,field_part_time_doctoral_students_total,field_part_time_doctoral_students_science,field_part_time_doctoral_students_engineering,field_part_time_doctoral_students_health
10647,r001,All institutions<sup>a</sup>,All institutions<sup>a</sup>,,1,-,297223,206183,72980,18060,-,259683,183443,64020,12220,-,37540,22740,8960,5840
10647,r002,All institutions<sup>a</sup> -> U. Michigan,All institutions<sup>a</sup>,U. Michigan,2,1,4733,2790,1691,252,1,4664,2774,1642,248,147,69,16,49,4
10647,r003,"All institutions<sup>a</sup> -> U. Illinois, Urbana-Champaign",All institutions<sup>a</sup>,"U. Illinois, Urbana-Champaign",2,2,4505,2754,1663,88,2,4429,2705,1640,84,137,76,49,23,4
10647,r004,All institutions<sup>a</sup> -> Texas A&M U.,All institutions<sup>a</sup>,Texas A&M U.,2,3,4326,2512,1672,142,6,3830,2243,1462,125,12,496,269,210,17
10647,r005,All institutions<sup>a</sup> -> Purdue U.,All institutions<sup>a</sup>,Purdue U.,2,4,4323,2065,2058,200,15,3386,1697,1505,184,4,937,368,553,16
10647,r006,"All institutions<sup>a</sup> -> U. California, Berkeley",All institutions<sup>a</sup>,"U. California, Berkeley",2,5,4144,3099,1002,43,3,4144,3099,1002,43,356,0,0,0,0
10647,r007,All institutions<sup>a</sup> -> U. Wisconsin-Madison,All institutions<sup>a</sup>,U. Wisconsin-Madison,2,6,4133,3035,798,300,10,3686,2659,753,274,17,447,376,45,26
10647,r008,All institutions<sup>a</sup> -> Pennsylvania State U.,All institutions<sup>a</sup>,Pennsylvania State U.,2,7,3997,2534,1371,92,5,3855,2449,1332,74,78,142,85,39,18
10647,r009,All institutions<sup>a</sup> -> Stanford U.,All institutions<sup>a</sup>,Stanford U.,2,8,3992,2589,1343,60,4,3983,2585,1338,60,291,9,4,5,0
10647,r010,All institutions<sup>a</sup> -> U. Washington,All institutions<sup>a</sup>,U. Washington,2,9,3905,2684,840,381,9,3718,2582,794,342,56,187,102,46,39
10647,r011,"All institutions<sup>a</sup> -> U. Texas, Austin",All institutions<sup>a</sup>,"U. Texas, Austin",2,10,3897,2141,1518,238,12,3623,2025,1403,195,32,274,116,115,43
10647,r012,All institutions<sup>a</sup> -> Cornell U.,All institutions<sup>a</sup>,Cornell U.,2,11,3739,2892,847,0,7,3723,2877,846,0,262,16,15,1,0
10647,r013,"All institutions<sup>a</sup> -> U. California, Los Angeles",All institutions<sup>a</sup>,"U. California, Los Angeles",2,12,3723,2676,879,168,7,3723,2676,879,168,356,0,0,0,0
10647,r014,"All institutions<sup>a</sup> -> U. Maryland, College Park",All institutions<sup>a</sup>,"U. Maryland, College Park",2,13,3716,2600,827,289,14,3467,2460,761,246,37,249,140,66,43
10647,r015,All institutions<sup>a</sup> -> Ohio State U.,All institutions<sup>a</sup>,Ohio State U.,2,14,3642,2444,1015,183,13,3568,2420,976,172,140,74,24,39,11
10647,r016,All institutions<sup>a</sup> -> Massachusetts Institute of Technology,All institutions<sup>a</sup>,Massachusetts Institute of Technology,2,15,3634,2078,1556,0,11,3628,2077,1551,0,312,6,1,5,0
10647,r017,All institutions<sup>a</sup> -> Johns Hopkins U.,All institutions<sup>a</sup>,Johns Hopkins U.,2,16,3559,2065,863,631,23,2930,1894,856,180,8,629,171,7,451
10647,r018,All institutions<sup>a</sup> -> Georgia Institute of Technology,All institutions<sup>a</sup>,Georgia Institute of Technology,2,17,3538,1356,2182,0,16,3302,1270,2032,0,41,236,86,150,0
10647,r019,All institutions<sup>a</sup> -> U. Colorado,All institutions<sup>a</sup>,U. Colorado,2,18,3492,2427,917,148,21,3159,2237,812,110,26,333,190,105,38
10647,r020,All institutions<sup>a</sup> -> U. Minnesota,All institutions<sup>a</sup>,U. Minnesota,2,19,3417,2383,806,228,20,3244,2271,761,212,61,173,112,45,16
10647,r021,"All institutions<sup>a</sup> -> U. California, San Diego",All institutions<sup>a</sup>,"U. California, San Diego",2,20,3311,2495,816,0,18,3262,2472,790,0,174,49,23,26,0
10647,r022,"All institutions<sup>a</sup> -> U. California, Davis",All institutions<sup>a</sup>,"U. California, Davis",2,21,3289,2613,627,49,19,3260,2598,614,48,220,29,15,13,1
10647,r023,All institutions<sup>a</sup> -> Harvard U.,All institutions<sup>a</sup>,Harvard U.,2,22,3283,2869,319,95,17,3282,2868,319,95,344,1,1,0,0
10647,r024,All institutions<sup>a</sup> -> U. Florida,All institutions<sup>a</sup>,U. Florida,2,23,3260,2210,858,192,22,3018,2052,796,170,38,242,158,62,22
10647,r025,All institutions<sup>a</sup> -> Arizona State U.,All institutions<sup>a</sup>,Arizona State U.,2,24,2908,1953,887,68,38,2097,1378,671,48,6,811,575,216,20
10647,r026,All institutions<sup>a</sup> -> North Carolina State U.,All institutions<sup>a</sup>,North Carolina State U.,2,25,2907,1586,1321,0,26,2677,1488,1189,0,42,230,98,132,0
10647,r027,All institutions<sup>a</sup> -> Indiana U.,All institutions<sup>a</sup>,Indiana U.,2,26,2884,2161,204,519,45,1820,1358,99,363,1,1064,803,105,156
10647,r028,All institutions<sup>a</sup> -> U. Pennsylvania,All institutions<sup>a</sup>,U. Pennsylvania,2,27,2809,2118,640,51,25,2769,2103,616,50,190,40,15,24,1
10647,r029,All institutions<sup>a</sup> -> Northwestern U.,All institutions<sup>a</sup>,Northwestern U.,2,28,2790,1859,891,40,24,2777,1850,887,40,268,13,9,4,0
10647,r030,All institutions<sup>a</sup> -> Virginia Polytechnic Institute and State U.,All institutions<sup>a</sup>,Virginia Polytechnic Institute and State U.,2,29,2673,1480,1193,0,30,2400,1341,1059,0,33,273,139,134,0
10647,r031,All institutions<sup>a</sup> -> U. Southern California,All institutions<sup>a</sup>,U. Southern California,2,30,2666,1750,756,160,27,2637,1739,739,159,220,29,11,17,1
10647,r032,"All institutions<sup>a</sup> -> U. North Carolina, Chapel Hill",All institutions<sup>a</sup>,"U. North Carolina, Chapel Hill",2,31,2568,2203,102,263,28,2515,2171,93,251,168,53,32,9,12
10647,r033,All institutions<sup>a</sup> -> Columbia U. in the City of New York,All institutions<sup>a</sup>,Columbia U. in the City of New York,2,32,2516,1813,640,63,29,2444,1770,619,55,144,72,43,21,8
10647,r034,All institutions<sup>a</sup> -> Michigan State U.,All institutions<sup>a</sup>,Michigan State U.,2,33,2473,1962,444,67,31,2379,1880,435,64,116,94,82,9,3
10647,r035,"All institutions<sup>a</sup> -> Rutgers, State U. New Jersey",All institutions<sup>a</sup>,"Rutgers, State U. New Jersey",2,34,2448,2044,378,26,43,1963,1622,315,26,13,485,422,63,0
10647,r036,All institutions<sup>a</sup> -> U. Chicago,All institutions<sup>a</sup>,U. Chicago,2,35,2359,2102,257,0,32,2359,2102,257,0,356,0,0,0,0
10647,r037,All institutions<sup>a</sup> -> U. Pittsburgh,All institutions<sup>a</sup>,U. Pittsburgh,2,36,2335,1538,541,256,33,2250,1491,527,232,125,85,47,14,24
10647,r038,All institutions<sup>a</sup> -> Boston U.,All institutions<sup>a</sup>,Boston U.,2,37,2253,1420,559,274,35,2212,1403,557,252,185,41,17,2,22
10647,r039,"All institutions<sup>a</sup> -> U. California, Irvine",All institutions<sup>a</sup>,"U. California, Irvine",2,38,2238,1604,634,0,34,2230,1598,632,0,300,8,6,2,0
10647,r040,All institutions<sup>a</sup> -> Princeton U.,All institutions<sup>a</sup>,Princeton U.,2,39,2209,1646,563,0,36,2209,1646,563,0,356,0,0,0,0
10647,r041,All institutions<sup>a</sup> -> U. Arizona,All institutions<sup>a</sup>,U. Arizona,2,40,2192,1726,315,151,51,1692,1326,258,108,11,500,400,57,43
10647,r042,All institutions<sup>a</sup> -> New York U.,All institutions<sup>a</sup>,New York U.,2,41,2182,1745,321,116,40,2006,1609,310,87,59,176,136,11,29
10647,r043,All institutions<sup>a</sup> -> U. Georgia,All institutions<sup>a</sup>,U. Georgia,2,42,2163,1873,136,154,41,1991,1718,132,141,62,172,155,4,13
10647,r044,All institutions<sup>a</sup> -> U. New Mexico,All institutions<sup>a</sup>,U. New Mexico,2,43,2131,1369,473,289,81,1149,784,179,186,2,982,585,294,103
10647,r045,All institutions<sup>a</sup> -> Duke U.,All institutions<sup>a</sup>,Duke U.,2,44,2126,1488,592,46,37,2126,1488,592,46,356,0,0,0,0
10647,r046,All institutions<sup>a</sup> -> Yale U.,All institutions<sup>a</sup>,Yale U.,2,45,2075,1641,323,111,39,2075,1641,323,111,356,0,0,0,0
10647,r047,All institutions<sup>a</sup> -> U. Connecticut,All institutions<sup>a</sup>,U. Connecticut,2,46,2027,1328,563,136,44,1829,1207,509,113,51,198,121,54,23
10647,r048,"All institutions<sup>a</sup> -> U. Illinois, Chicago",All institutions<sup>a</sup>,"U. Illinois, Chicago",2,47,2007,1165,394,448,57,1554,940,339,275,15,453,225,55,173
10647,r049,All institutions<sup>a</sup> -> Carnegie Mellon U.,All institutions<sup>a</sup>,Carnegie Mellon U.,2,48,1998,1081,917,0,42,1970,1065,905,0,226,28,16,12,0
10647,r050,"All institutions<sup>a</sup> -> U. Massachusetts, Amherst",All institutions<sup>a</sup>,"U. Massachusetts, Amherst",2,49,1975,1484,427,64,49,1745,1321,376,48,42,230,163,51,16
10647,r051,All institutions<sup>a</sup> -> U. Utah,All institutions<sup>a</sup>,U. Utah,2,50,1974,1269,533,172,52,1668,1089,451,128,29,306,180,82,44
10647,r052,All institutions<sup>a</sup> -> Iowa State U.,All institutions<sup>a</sup>,Iowa State U.,2,51,1879,1249,614,16,68,1283,846,425,12,10,596,403,189,4
10647,r053,"All institutions<sup>a</sup> -> U. Tennessee, Knoxville",All institutions<sup>a</sup>,"U. Tennessee, Knoxville",2,52,1869,1103,690,76,91,954,601,315,38,5,915,502,375,38
10647,r054,All institutions<sup>a</sup> -> U. Virginia,All institutions<sup>a</sup>,U. Virginia,2,53,1827,1170,634,23,46,1806,1157,627,22,247,21,13,7,1
10647,r055,"All institutions<sup>a</sup> -> U. California, Riverside",All institutions<sup>a</sup>,"U. California, Riverside",2,54,1810,1443,367,0,47,1798,1431,367,0,273,12,12,0,0
10647,r056,"All institutions<sup>a</sup> -> Washington U., Saint Louis",All institutions<sup>a</sup>,"Washington U., Saint Louis",2,55,1790,1342,435,13,48,1789,1342,434,13,344,1,0,1,0
10647,r057,"All institutions<sup>a</sup> -> SUNY, Stony Brook U.",All institutions<sup>a</sup>,"SUNY, Stony Brook U.",2,55,1790,1410,339,41,50,1733,1397,314,22,161,57,13,25,19
10647,r058,All institutions<sup>a</sup> -> Liberty U.,All institutions<sup>a</sup>,Liberty U.,2,57,1688,1325,24,339,87,1062,761,21,280,9,626,564,3,59
10647,r059,All institutions<sup>a</sup> -> U. Delaware,All institutions<sup>a</sup>,U. Delaware,2,58,1676,1137,518,21,55,1645,1119,510,16,209,31,18,8,5
10647,r060,All institutions<sup>a</sup> -> Vanderbilt U.,All institutions<sup>a</sup>,Vanderbilt U.,2,59,1656,1246,370,40,54,1647,1240,369,38,291,9,6,1,2
10647,r061,"All institutions<sup>a</sup> -> U. California, Santa Barbara",All institutions<sup>a</sup>,"U. California, Santa Barbara",2,60,1651,1322,329,0,53,1651,1322,329,0,356,0,0,0,0
10647,r062,"All institutions<sup>a</sup> -> Colorado State U., Fort Collins",All institutions<sup>a</sup>,"Colorado State U., Fort Collins",2,61,1623,1168,434,21,115,670,547,110,13,3,953,621,324,8
10647,r063,All institutions<sup>a</sup> -> U. Houston,All institutions<sup>a</sup>,U. Houston,2,62,1621,956,558,107,64,1380,802,481,97,39,241,154,77,10
10647,r064,"All institutions<sup>a</sup> -> CUNY, Graduate Center",All institutions<sup>a</sup>,"CUNY, Graduate Center",2,63,1580,1526,0,54,56,1573,1519,0,54,307,7,7,0,0
10647,r065,All institutions<sup>a</sup> -> Florida State U.,All institutions<sup>a</sup>,Florida State U.,2,64,1545,1261,206,78,63,1386,1149,189,48,67,159,112,17,30
10647,r066,All institutions<sup>a</sup> -> George Mason U.,All institutions<sup>a</sup>,George Mason U.,2,65,1528,1309,186,33,79,1184,1008,149,27,25,344,301,37,6
10647,r067,"All institutions<sup>a</sup> -> SUNY, U. Buffalo",All institutions<sup>a</sup>,"SUNY, U. Buffalo",2,66,1519,1058,355,106,60,1409,998,333,78,103,110,60,22,28
10647,r068,All institutions<sup>a</sup> -> Northeastern U.<sup>b</sup>,All institutions<sup>a</sup>,Northeastern U.<sup>b</sup>,2,67,1494,756,674,64,58,1469,753,657,59,232,25,3,17,5
10647,r069,"All institutions<sup>a</sup> -> U. South Florida, Tampa",All institutions<sup>a</sup>,"U. South Florida, Tampa",2,68,1488,902,367,219,76,1228,794,325,109,35,260,108,42,110
10647,r070,All institutions<sup>a</sup> -> Texas Tech U.,All institutions<sup>a</sup>,Texas Tech U.,2,69,1478,1026,396,56,69,1280,911,322,47,51,198,115,74,9
10647,r071,All institutions<sup>a</sup> -> Auburn U.,All institutions<sup>a</sup>,Auburn U.,2,70,1462,787,622,53,90,1009,498,467,44,15,453,289,155,9
10647,r072,All institutions<sup>a</sup> -> U. Notre Dame,All institutions<sup>a</sup>,U. Notre Dame,2,71,1461,858,603,0,59,1450,852,598,0,279,11,6,5,0
10647,r073,All institutions<sup>a</sup> -> Louisiana State U.,All institutions<sup>a</sup>,Louisiana State U.,2,72,1436,1061,290,85,66,1290,965,254,71,76,146,96,36,14
10647,r074,All institutions<sup>a</sup> -> Emory U.,All institutions<sup>a</sup>,Emory U.,2,73,1421,1108,234,79,67,1284,1105,100,79,82,137,3,134,0
10647,r075,All institutions<sup>a</sup> -> Oregon State U.,All institutions<sup>a</sup>,Oregon State U.,2,74,1402,942,377,83,73,1269,864,334,71,85,133,78,43,12
10647,r076,All institutions<sup>a</sup> -> Rice U.,All institutions<sup>a</sup>,Rice U.,2,75,1400,847,553,0,61,1397,845,552,0,326,3,2,1,0
10647,r077,All institutions<sup>a</sup> -> California Institute of Technology,All institutions<sup>a</sup>,California Institute of Technology,2,76,1395,852,543,0,62,1395,852,543,0,356,0,0,0,0
10647,r078,All institutions<sup>a</sup> -> U. Iowa,All institutions<sup>a</sup>,U. Iowa,2,77,1392,1057,202,133,77,1210,932,172,106,57,182,125,30,27
10647,r079,All institutions<sup>a</sup> -> U. Kansas,All institutions<sup>a</sup>,U. Kansas,2,78,1385,1044,204,137,70,1276,974,194,108,104,109,70,10,29
10647,r080,All institutions<sup>a</sup> -> U. Central Florida,All institutions<sup>a</sup>,U. Central Florida,2,79,1382,780,560,42,74,1234,710,495,29,75,148,70,65,13
10647,r081,All institutions<sup>a</sup> -> Clemson U.,All institutions<sup>a</sup>,Clemson U.,2,80,1380,781,558,41,75,1231,684,513,34,73,149,97,45,7
10647,r082,All institutions<sup>a</sup> -> U. Kentucky,All institutions<sup>a</sup>,U. Kentucky,2,81,1341,968,232,141,72,1273,935,224,114,149,68,33,8,27
10647,r083,All institutions<sup>a</sup> -> U. Rochester,All institutions<sup>a</sup>,U. Rochester,2,82,1329,1070,241,18,65,1321,1062,241,18,300,8,8,0,0
10647,r084,All institutions<sup>a</sup> -> U. Cincinnati,All institutions<sup>a</sup>,U. Cincinnati,2,83,1312,745,380,187,84,1086,668,277,141,45,226,77,103,46
10647,r085,All institutions<sup>a</sup> -> George Washington U.,All institutions<sup>a</sup>,George Washington U.,2,84,1278,808,239,231,125,570,431,80,59,7,708,377,159,172
10647,r086,All institutions<sup>a</sup> -> Brown U.,All institutions<sup>a</sup>,Brown U.,2,85,1277,1079,152,46,71,1275,1079,151,45,336,2,0,1,1
10647,r087,"All institutions<sup>a</sup> -> U. Texas, Dallas",All institutions<sup>a</sup>,"U. Texas, Dallas",2,86,1265,767,477,21,80,1151,707,425,19,99,114,60,52,2
10647,r088,All institutions<sup>a</sup> -> U. Nebraska-Lincoln,All institutions<sup>a</sup>,U. Nebraska-Lincoln,2,87,1220,924,296,0,86,1066,807,259,0,70,154,117,37,0
10647,r089,"All institutions<sup>a</sup> -> U. California, Santa Cruz",All institutions<sup>a</sup>,"U. California, Santa Cruz",2,88,1217,1155,62,0,78,1195,1136,59,0,242,22,19,3,0
10647,r090,All institutions<sup>a</sup> -> Washington State U.,All institutions<sup>a</sup>,Washington State U.,2,88,1217,879,286,52,82,1121,821,263,37,114,96,58,23,15
10647,r091,All institutions<sup>a</sup> -> U. South Carolina,All institutions<sup>a</sup>,U. South Carolina,2,90,1167,747,250,170,88,1054,693,227,134,101,113,54,23,36
10647,r092,All institutions<sup>a</sup> -> U. Oklahoma,All institutions<sup>a</sup>,U. Oklahoma,2,91,1163,873,241,49,89,1011,773,202,36,71,152,100,39,13
10647,r093,All institutions<sup>a</sup> -> Florida International U.,All institutions<sup>a</sup>,Florida International U.,2,92,1148,774,297,77,84,1086,742,284,60,154,62,32,13,17
10647,r094,"All institutions<sup>a</sup> -> U. Missouri, Columbia",All institutions<sup>a</sup>,"U. Missouri, Columbia",2,93,1142,859,183,100,106,791,663,86,42,23,351,196,97,58
10647,r095,All institutions<sup>a</sup> -> Case Western Reserve U.,All institutions<sup>a</sup>,Case Western Reserve U.,2,94,1131,693,355,83,83,1090,671,345,74,185,41,22,10,9
10647,r096,"All institutions<sup>a</sup> -> SUNY, Binghamton U.",All institutions<sup>a</sup>,"SUNY, Binghamton U.",2,94,1131,841,271,19,98,834,654,170,10,30,297,187,101,9
10647,r097,All institutions<sup>a</sup> -> West Virginia U.,All institutions<sup>a</sup>,West Virginia U.,2,96,1005,687,214,104,95,869,598,191,80,84,136,89,23,24
10647,r098,"All institutions<sup>a</sup> -> U. Texas Health Science Center, Houston",All institutions<sup>a</sup>,"U. Texas Health Science Center, Houston",2,97,990,784,40,166,112,694,575,40,79,31,296,209,0,87
10647,r099,All institutions<sup>a</sup> -> Georgia State U.,All institutions<sup>a</sup>,Georgia State U.,2,98,974,832,0,142,97,835,764,0,71,80,139,68,0,71
10647,r100,All institutions<sup>a</sup> -> Wayne State U.,All institutions<sup>a</sup>,Wayne State U.,2,99,972,702,175,95,94,880,660,139,81,119,92,42,36,14
10647,r101,All institutions<sup>a</sup> -> Virginia Commonwealth U.,All institutions<sup>a</sup>,Virginia Commonwealth U.,2,99,972,494,149,329,96,846,436,134,276,90,126,58,15,53
10647,r102,All institutions<sup>a</sup> -> Mississippi State U.,All institutions<sup>a</sup>,Mississippi State U.,2,101,960,563,377,20,119,602,422,167,13,21,358,141,210,7
10647,r103,"All institutions<sup>a</sup> -> U. Alabama, Tuscaloosa",All institutions<sup>a</sup>,"U. Alabama, Tuscaloosa",2,102,943,574,334,35,101,812,516,274,22,87,131,58,60,13
10647,r104,"All institutions<sup>a</sup> -> U. Alabama, Birmingham",All institutions<sup>a</sup>,"U. Alabama, Birmingham",2,103,940,745,113,82,104,797,677,76,44,77,143,68,37,38
10647,r105,All institutions<sup>a</sup> -> Syracuse U.,All institutions<sup>a</sup>,Syracuse U.,2,104,925,743,170,12,99,831,669,150,12,116,94,74,20,0
10647,r106,All institutions<sup>a</sup> -> U. Miami,All institutions<sup>a</sup>,U. Miami,2,105,923,742,136,45,93,905,730,132,43,257,18,12,4,2
10647,r107,"All institutions<sup>a</sup> -> U. California, San Francisco",All institutions<sup>a</sup>,"U. California, San Francisco",2,106,920,745,98,77,92,920,745,98,77,356,0,0,0,0
10647,r108,"All institutions<sup>a</sup> -> U. Hawaii, Manoa",All institutions<sup>a</sup>,"U. Hawaii, Manoa",2,107,918,779,111,28,103,799,676,104,19,96,119,103,7,9
10647,r109,"All institutions<sup>a</sup> -> U. Texas, Arlington",All institutions<sup>a</sup>,"U. Texas, Arlington",2,108,891,476,370,45,122,583,309,260,14,27,308,167,110,31
10647,r110,All institutions<sup>a</sup> -> Drexel U.,All institutions<sup>a</sup>,Drexel U.,2,109,882,507,314,61,105,792,453,284,55,122,90,54,30,6
10647,r111,All institutions<sup>a</sup> -> Oklahoma State U.,All institutions<sup>a</sup>,Oklahoma State U.,2,110,881,666,215,0,114,671,506,165,0,49,210,160,50,0
10647,r112,"All institutions<sup>a</sup> -> U. North Texas, Denton",All institutions<sup>a</sup>,"U. North Texas, Denton",2,111,875,715,129,31,138,470,377,82,11,18,405,338,47,20
10647,r113,"All institutions<sup>a</sup> -> SUNY, U. Albany",All institutions<sup>a</sup>,"SUNY, U. Albany",2,112,861,792,25,44,152,390,361,16,13,14,471,431,9,31
10647,r114,All institutions<sup>a</sup> -> U. Oregon,All institutions<sup>a</sup>,U. Oregon,2,113,851,844,0,7,100,822,817,0,5,220,29,27,0,2
10647,r115,All institutions<sup>a</sup> -> Temple U.,All institutions<sup>a</sup>,Temple U.,2,114,850,727,87,36,102,809,697,78,34,185,41,30,9,2
10647,r116,"All institutions<sup>a</sup> -> U. Nevada, Reno",All institutions<sup>a</sup>,"U. Nevada, Reno",2,115,846,584,240,22,107,782,538,224,20,150,64,46,16,2
10647,r117,All institutions<sup>a</sup> -> Tufts U.,All institutions<sup>a</sup>,Tufts U.,2,116,839,653,172,14,108,764,604,146,14,139,75,49,26,0
10647,r118,"All institutions<sup>a</sup> -> U. Arkansas, Fayetteville",All institutions<sup>a</sup>,"U. Arkansas, Fayetteville",2,117,828,534,293,1,140,443,309,134,0,20,385,225,159,1
10647,r119,All institutions<sup>a</sup> -> Tulane U.,All institutions<sup>a</sup>,Tulane U.,2,118,810,626,78,106,110,725,589,76,60,125,85,37,2,46
10647,r120,All institutions<sup>a</sup> -> Kansas State U.,All institutions<sup>a</sup>,Kansas State U.,2,119,768,648,120,0,116,660,557,103,0,107,108,91,17,0
10647,r121,All institutions<sup>a</sup> -> U. Wisconsin-Milwaukee,All institutions<sup>a</sup>,U. Wisconsin-Milwaukee,2,120,763,473,130,160,111,705,449,117,139,158,58,24,13,21
10647,r122,All institutions<sup>a</sup> -> Dartmouth C.,All institutions<sup>a</sup>,Dartmouth C.,2,121,728,575,142,11,109,728,575,142,11,356,0,0,0,0
10647,r123,All institutions<sup>a</sup> -> Claremont Graduate U.,All institutions<sup>a</sup>,Claremont Graduate U.,2,122,720,629,0,91,134,483,427,0,56,40,237,202,0,35
10647,r124,"All institutions<sup>a</sup> -> U. Maryland, Baltimore County",All institutions<sup>a</sup>,"U. Maryland, Baltimore County",2,123,706,579,127,0,127,565,461,104,0,79,141,118,23,0
10647,r125,All institutions<sup>a</sup> -> Baylor U.,All institutions<sup>a</sup>,Baylor U.,2,124,702,593,83,26,113,683,575,82,26,253,19,18,1,0
10647,r126,"All institutions<sup>a</sup> -> U. Nevada, Las Vegas",All institutions<sup>a</sup>,"U. Nevada, Las Vegas",2,124,702,554,86,62,130,526,432,65,29,59,176,122,21,33
10647,r127,All institutions<sup>a</sup> -> Colorado School of Mines,All institutions<sup>a</sup>,Colorado School of Mines,2,126,699,219,480,0,118,610,197,413,0,123,89,22,67,0
10647,r128,"All institutions<sup>a</sup> -> Rensselaer Polytechnic Institute, Troy",All institutions<sup>a</sup>,"Rensselaer Polytechnic Institute, Troy",2,127,642,246,396,0,117,634,246,388,0,300,8,0,8,0
10647,r129,All institutions<sup>a</sup> -> Old Dominion U.,All institutions<sup>a</sup>,Old Dominion U.,2,128,641,377,221,43,177,289,194,78,17,22,352,183,143,26
10647,r130,All institutions<sup>a</sup> -> U. Louisville,All institutions<sup>a</sup>,U. Louisville,2,129,630,464,136,30,128,556,413,126,17,140,74,51,10,13
10647,r131,"All institutions<sup>a</sup> -> U. Texas, San Antonio",All institutions<sup>a</sup>,"U. Texas, San Antonio",2,130,627,396,225,6,142,434,284,148,2,53,193,112,77,4
10647,r132,"All institutions<sup>a</sup> -> U. Massachusetts, Boston",All institutions<sup>a</sup>,"U. Massachusetts, Boston",2,131,624,521,0,103,160,373,343,0,30,36,251,178,0,73
10647,r133,"All institutions<sup>a</sup> -> U. North Carolina, Charlotte",All institutions<sup>a</sup>,"U. North Carolina, Charlotte",2,132,621,417,165,39,143,433,301,115,17,55,188,116,50,22
10647,r134,All institutions<sup>a</sup> -> Lehigh U.,All institutions<sup>a</sup>,Lehigh U.,2,133,615,336,279,0,120,586,323,263,0,220,29,13,16,0
10647,r135,All institutions<sup>a</sup> -> Kent State U.,All institutions<sup>a</sup>,Kent State U.,2,134,602,529,12,61,124,576,515,11,50,230,26,14,1,11
10647,r136,"All institutions<sup>a</sup> -> U. Massachusetts, Lowell",All institutions<sup>a</sup>,"U. Massachusetts, Lowell",2,135,590,260,266,64,146,429,202,191,36,66,161,58,75,28
10647,r137,All institutions<sup>a</sup> -> North Dakota State U.,All institutions<sup>a</sup>,North Dakota State U.,2,136,588,404,158,26,148,425,286,115,24,65,163,118,43,2
10647,r138,"All institutions<sup>a</sup> -> U. California, Merced",All institutions<sup>a</sup>,"U. California, Merced",2,137,587,417,141,29,121,585,415,141,29,336,2,2,0,0
10647,r139,"All institutions<sup>a</sup> -> U. Texas, El Paso",All institutions<sup>a</sup>,"U. Texas, El Paso",2,138,586,349,204,33,159,375,235,121,19,48,211,114,83,14
10647,r140,All institutions<sup>a</sup> -> Baylor C. of Medicine,All institutions<sup>a</sup>,Baylor C. of Medicine,2,139,583,581,0,2,122,583,581,0,2,356,0,0,0,0
10647,r141,All institutions<sup>a</sup> -> Georgetown U.,All institutions<sup>a</sup>,Georgetown U.,2,140,578,573,0,5,126,568,563,0,5,284,10,10,0,0
10647,r142,All institutions<sup>a</sup> -> Florida Institute of Technology,All institutions<sup>a</sup>,Florida Institute of Technology,2,141,552,354,198,0,129,529,342,187,0,237,23,12,11,0
10647,r143,All institutions<sup>a</sup> -> Fielding Graduate U.,All institutions<sup>a</sup>,Fielding Graduate U.,2,142,546,546,0,0,136,473,473,0,0,142,73,73,0,0
10647,r144,All institutions<sup>a</sup> -> Utah State U.,All institutions<sup>a</sup>,Utah State U.,2,142,546,403,143,0,200,201,139,62,0,24,345,264,81,0
10647,r145,All institutions<sup>a</sup> -> U. Toledo,All institutions<sup>a</sup>,U. Toledo,2,144,526,382,104,40,158,377,276,72,29,73,149,106,32,11
10647,r146,All institutions<sup>a</sup> -> U. Mississippi,All institutions<sup>a</sup>,U. Mississippi,2,145,522,365,44,113,137,471,349,39,83,170,51,16,5,30
10647,r147,All institutions<sup>a</sup> -> Missouri U. of Science and Technology,All institutions<sup>a</sup>,Missouri U. of Science and Technology,2,145,522,153,369,0,139,459,140,319,0,151,63,13,50,0
10647,r148,All institutions<sup>a</sup> -> U. North Dakota,All institutions<sup>a</sup>,U. North Dakota,2,145,522,221,240,61,169,333,167,137,29,54,189,54,103,32
10647,r149,All institutions<sup>a</sup> -> U. Memphis,All institutions<sup>a</sup>,U. Memphis,2,148,515,361,113,41,176,291,211,65,15,46,224,150,48,26
10647,r150,All institutions<sup>a</sup> -> Boston C.,All institutions<sup>a</sup>,Boston C.,2,149,509,487,0,22,132,498,480,0,18,279,11,7,0,4
10647,r151,All institutions<sup>a</sup> -> Florida Atlantic U.,All institutions<sup>a</sup>,Florida Atlantic U.,2,149,509,354,115,40,191,236,170,56,10,33,273,184,59,30
10647,r152,All institutions<sup>a</sup> -> U. Texas Southwestern Medical Center,All institutions<sup>a</sup>,U. Texas Southwestern Medical Center,2,151,506,445,61,0,131,505,444,61,0,344,1,1,0,0
10647,r153,All institutions<sup>a</sup> -> U. New Hampshire,All institutions<sup>a</sup>,U. New Hampshire,2,152,499,393,106,0,133,487,383,104,0,273,12,10,2,0
10647,r154,All institutions<sup>a</sup> -> U. Vermont,All institutions<sup>a</sup>,U. Vermont,2,153,483,408,51,24,145,430,375,45,10,168,53,33,6,14
10647,r155,All institutions<sup>a</sup> -> Worcester Polytechnic Institute,All institutions<sup>a</sup>,Worcester Polytechnic Institute,2,154,481,211,270,0,163,359,154,205,0,95,122,57,65,0
10647,r156,All institutions<sup>a</sup> -> Brigham Young U.,All institutions<sup>a</sup>,Brigham Young U.,2,155,478,322,154,2,214,171,127,43,1,28,307,195,111,1
10647,r157,All institutions<sup>a</sup> -> San Diego State U.,All institutions<sup>a</sup>,San Diego State U.,2,156,475,315,62,98,135,475,315,62,98,356,0,0,0,0
10647,r158,All institutions<sup>a</sup> -> Michigan Technological U.,All institutions<sup>a</sup>,Michigan Technological U.,2,157,472,233,239,0,154,388,201,187,0,129,84,32,52,0
10647,r159,All institutions<sup>a</sup> -> New Mexico State U.,All institutions<sup>a</sup>,New Mexico State U.,2,157,472,325,133,14,155,386,274,101,11,124,86,51,32,3
10647,r160,All institutions<sup>a</sup> -> Stevens Institute of Technology,All institutions<sup>a</sup>,Stevens Institute of Technology,2,159,470,184,286,0,141,436,177,259,0,205,34,7,27,0
10647,r161,All institutions<sup>a</sup> -> Howard U.,All institutions<sup>a</sup>,Howard U.,2,160,461,396,35,30,167,345,297,25,23,97,116,99,10,7
10647,r162,All institutions<sup>a</sup> -> U. Wyoming,All institutions<sup>a</sup>,U. Wyoming,2,161,460,334,66,60,164,356,284,53,19,110,104,50,13,41
10647,r163,All institutions<sup>a</sup> -> Texas Woman's U.,All institutions<sup>a</sup>,Texas Woman's U.,2,162,459,238,0,221,274,71,59,0,12,19,388,179,0,209
10647,r164,All institutions<sup>a</sup> -> Saint Louis U.,All institutions<sup>a</sup>,Saint Louis U.,2,163,456,348,27,81,144,432,333,23,76,235,24,15,4,5
10647,r165,"All institutions<sup>a</sup> -> Southern Illinois U., Carbondale",All institutions<sup>a</sup>,"Southern Illinois U., Carbondale",2,164,455,382,73,0,170,329,281,48,0,90,126,101,25,0
10647,r166,"All institutions<sup>a</sup> -> U. Nebraska, Medical Center",All institutions<sup>a</sup>,"U. Nebraska, Medical Center",2,165,454,344,0,110,192,227,182,0,45,44,227,162,0,65
10647,r167,All institutions<sup>a</sup> -> U. Rhode Island,All institutions<sup>a</sup>,U. Rhode Island,2,166,448,316,75,57,153,389,284,63,42,157,59,32,12,15
10647,r168,All institutions<sup>a</sup> -> Montana State U.,All institutions<sup>a</sup>,Montana State U.,2,167,447,356,91,0,151,399,318,81,0,175,48,38,10,0
10647,r169,All institutions<sup>a</sup> -> Brandeis U.,All institutions<sup>a</sup>,Brandeis U.,2,168,428,428,0,0,147,428,428,0,0,356,0,0,0,0
10647,r170,All institutions<sup>a</sup> -> Ohio U.,All institutions<sup>a</sup>,Ohio U.,2,169,426,297,101,28,164,356,267,68,21,145,70,30,33,7
10647,r171,All institutions<sup>a</sup> -> U. Maine,All institutions<sup>a</sup>,U. Maine,2,170,425,345,80,0,149,414,335,79,0,279,11,10,1,0
10647,r172,All institutions<sup>a</sup> -> New Jersey Institute of Technology,All institutions<sup>a</sup>,New Jersey Institute of Technology,2,171,421,214,207,0,156,382,199,183,0,191,39,15,24,0
10647,r173,All institutions<sup>a</sup> -> Palo Alto U.,All institutions<sup>a</sup>,Palo Alto U.,2,172,412,412,0,0,150,400,400,0,0,273,12,12,0,0
10647,r174,All institutions<sup>a</sup> -> Rochester Institute of Technology,All institutions<sup>a</sup>,Rochester Institute of Technology,2,172,412,264,148,0,161,365,238,127,0,176,47,26,21,0
10647,r175,All institutions<sup>a</sup> -> Illinois Institute of Technology,All institutions<sup>a</sup>,Illinois Institute of Technology,2,174,407,248,159,0,156,382,230,152,0,232,25,18,7,0
10647,r176,All institutions<sup>a</sup> -> U. Idaho,All institutions<sup>a</sup>,U. Idaho,2,175,406,312,94,0,172,314,255,59,0,119,92,57,35,0
10647,r177,"All institutions<sup>a</sup> -> U. North Carolina, Greensboro",All institutions<sup>a</sup>,"U. North Carolina, Greensboro",2,176,395,236,0,159,212,174,127,0,47,47,221,109,0,112
10647,r178,All institutions<sup>a</sup> -> Western Michigan U.,All institutions<sup>a</sup>,Western Michigan U.,2,177,394,277,82,35,162,364,269,74,21,216,30,8,8,14
10647,r179,All institutions<sup>a</sup> -> U. Southern Mississippi,All institutions<sup>a</sup>,U. Southern Mississippi,2,178,391,247,71,73,179,286,173,66,47,109,105,74,5,26
10647,r180,All institutions<sup>a</sup> -> Southern Methodist U.,All institutions<sup>a</sup>,Southern Methodist U.,2,179,384,282,102,0,168,342,256,86,0,183,42,26,16,0
10647,r181,All institutions<sup>a</sup> -> Northern Illinois U.,All institutions<sup>a</sup>,Northern Illinois U.,2,180,379,310,10,59,196,210,196,6,8,63,169,114,4,51
10647,r182,All institutions<sup>a</sup> -> Portland State U.,All institutions<sup>a</sup>,Portland State U.,2,181,369,342,23,4,186,257,242,15,0,102,112,100,8,4
10647,r183,All institutions<sup>a</sup> -> Oakland U.,All institutions<sup>a</sup>,Oakland U.,2,182,368,155,185,28,194,213,114,82,17,68,155,41,103,11
10647,r184,All institutions<sup>a</sup> -> Marquette U.,All institutions<sup>a</sup>,Marquette U.,2,183,356,230,91,35,190,240,163,65,12,97,116,67,26,23
10647,r185,"All institutions<sup>a</sup> -> U. Massachusetts, Medical School",All institutions<sup>a</sup>,"U. Massachusetts, Medical School",2,184,351,351,0,0,166,350,350,0,0,344,1,1,0,0
10647,r186,All institutions<sup>a</sup> -> Oregon Health and Science U.,All institutions<sup>a</sup>,Oregon Health and Science U.,2,185,343,213,81,49,173,308,206,80,22,199,35,7,1,27
10647,r187,All institutions<sup>a</sup> -> U. Akron,All institutions<sup>a</sup>,U. Akron,2,186,341,189,150,2,181,278,151,127,0,151,63,38,23,2
10647,r188,All institutions<sup>a</sup> -> Scripps Research Institute,All institutions<sup>a</sup>,Scripps Research Institute,2,187,322,322,0,0,171,322,322,0,0,356,0,0,0,0
10647,r189,All institutions<sup>a</sup> -> New School,All institutions<sup>a</sup>,New School,2,188,318,318,0,0,178,287,287,0,0,209,31,31,0,0
10647,r190,All institutions<sup>a</sup> -> Fordham U.,All institutions<sup>a</sup>,Fordham U.,2,189,315,315,0,0,208,184,184,0,0,87,131,131,0,0
10647,r191,"All institutions<sup>a</sup> -> U. Puerto Rico, Rio Piedras",All institutions<sup>a</sup>,"U. Puerto Rico, Rio Piedras",2,189,315,315,0,0,246,113,113,0,0,50,202,202,0,0
10647,r192,"All institutions<sup>a</sup> -> Columbia U., Teachers C.",All institutions<sup>a</sup>,"Columbia U., Teachers C.",2,191,312,295,0,17,183,269,255,0,14,182,43,40,0,3
10647,r193,All institutions<sup>a</sup> -> North Carolina Agricultural and Technical State U.,All institutions<sup>a</sup>,North Carolina Agricultural and Technical State U.,2,192,311,112,199,0,213,172,68,104,0,80,139,44,95,0
10647,r194,"All institutions<sup>a</sup> -> U. Missouri, Kansas City",All institutions<sup>a</sup>,"U. Missouri, Kansas City",2,193,309,210,39,60,211,177,123,22,32,86,132,87,17,28
10647,r195,All institutions<sup>a</sup> -> Medical C. Wisconsin,All institutions<sup>a</sup>,Medical C. Wisconsin,2,194,308,212,44,52,182,277,212,43,22,209,31,0,1,30
10647,r196,All institutions<sup>a</sup> -> Albert Einstein C. of Medicine,All institutions<sup>a</sup>,Albert Einstein C. of Medicine,2,195,307,298,0,9,174,307,298,0,9,356,0,0,0,0
10647,r197,All institutions<sup>a</sup> -> Wake Forest U.,All institutions<sup>a</sup>,Wake Forest U.,2,196,297,237,60,0,175,296,236,60,0,344,1,1,0,0
10647,r198,"All institutions<sup>a</sup> -> U. Louisiana, Lafayette",All institutions<sup>a</sup>,"U. Louisiana, Lafayette",2,197,296,194,85,17,188,251,177,64,10,180,45,17,21,7
10647,r199,All institutions<sup>a</sup> -> U. Montana,All institutions<sup>a</sup>,U. Montana,2,197,296,261,1,34,243,117,114,0,3,58,179,147,1,31
10647,r200,All institutions<sup>a</sup> -> Morgan State U.,All institutions<sup>a</sup>,Morgan State U.,2,199,293,104,115,74,180,284,100,113,71,291,9,4,2,3
10647,r201,"All institutions<sup>a</sup> -> U. Alabama, Huntsville",All institutions<sup>a</sup>,"U. Alabama, Huntsville",2,200,292,131,144,17,215,169,100,66,3,94,123,31,78,14
10647,r202,All institutions<sup>a</sup> -> Northern Arizona U.,All institutions<sup>a</sup>,Northern Arizona U.,2,201,291,279,12,0,189,244,232,12,0,176,47,47,0,0
10647,r203,"All institutions<sup>a</sup> -> U. Texas Health Science Center, San Antonio",All institutions<sup>a</sup>,"U. Texas Health Science Center, San Antonio",2,201,291,202,9,80,195,212,197,9,6,133,79,5,0,74
10647,r204,All institutions<sup>a</sup> -> U. South Dakota,All institutions<sup>a</sup>,U. South Dakota,2,203,283,153,10,120,205,187,125,5,57,114,96,28,5,63
10647,r205,All institutions<sup>a</sup> -> Bowling Green State U.,All institutions<sup>a</sup>,Bowling Green State U.,2,204,282,280,0,2,197,209,207,0,2,142,73,73,0,0
10647,r206,All institutions<sup>a</sup> -> Nova Southeastern U.,All institutions<sup>a</sup>,Nova Southeastern U.,2,204,282,211,0,71,222,151,133,0,18,87,131,78,0,53
10647,r207,All institutions<sup>a</sup> -> Boise State U.,All institutions<sup>a</sup>,Boise State U.,2,206,281,188,93,0,199,202,126,76,0,133,79,62,17,0
10647,r208,"All institutions<sup>a</sup> -> Mayo Clinic, Mayo Graduate School",All institutions<sup>a</sup>,"Mayo Clinic, Mayo Graduate School",2,207,267,225,42,0,184,267,225,42,0,356,0,0,0,0
10647,r209,All institutions<sup>a</sup> -> Icahn School of Medicine at Mt. Sinai,All institutions<sup>a</sup>,Icahn School of Medicine at Mt. Sinai,2,208,262,262,0,0,185,262,262,0,0,356,0,0,0,0
10647,r210,All institutions<sup>a</sup> -> U. Texas Medical Branch,All institutions<sup>a</sup>,U. Texas Medical Branch,2,209,260,175,0,85,203,190,159,0,31,145,70,16,0,54
10647,r211,All institutions<sup>a</sup> -> Rockefeller U.,All institutions<sup>a</sup>,Rockefeller U.,2,210,255,255,0,0,187,255,255,0,0,356,0,0,0,0
10647,r212,"All institutions<sup>a</sup> -> U. Arkansas, Little Rock",All institutions<sup>a</sup>,"U. Arkansas, Little Rock",2,211,254,231,23,0,223,150,137,13,0,110,104,94,10,0
10647,r213,"All institutions<sup>a</sup> -> U. Alaska, Fairbanks",All institutions<sup>a</sup>,"U. Alaska, Fairbanks",2,212,246,233,13,0,259,91,86,5,0,68,155,147,8,0
10647,r214,All institutions<sup>a</sup> -> Pontifical Catholic U. Puerto Rico,All institutions<sup>a</sup>,Pontifical Catholic U. Puerto Rico,2,213,242,242,0,0,259,91,91,0,0,72,151,151,0,0
10647,r215,All institutions<sup>a</sup> -> Loma Linda U.,All institutions<sup>a</sup>,Loma Linda U.,2,214,236,133,0,103,238,127,87,0,40,104,109,46,0,63
10647,r216,"All institutions<sup>a</sup> -> Keiser U., Fort Lauderdale",All institutions<sup>a</sup>,"Keiser U., Fort Lauderdale",2,215,225,225,0,0,225,149,149,0,0,137,76,76,0,0
10647,r217,All institutions<sup>a</sup> -> U. Denver,All institutions<sup>a</sup>,U. Denver,2,216,224,200,24,0,200,201,186,15,0,237,23,14,9,0
10647,r218,All institutions<sup>a</sup> -> Wichita State U.,All institutions<sup>a</sup>,Wichita State U.,2,216,224,88,130,6,263,87,42,42,3,82,137,46,88,3
10647,r219,"All institutions<sup>a</sup> -> U. Tennessee, Health Science Center",All institutions<sup>a</sup>,"U. Tennessee, Health Science Center",2,218,218,132,0,86,193,218,132,0,86,356,0,0,0,0
10647,r220,All institutions<sup>a</sup> -> South Dakota State U.,All institutions<sup>a</sup>,South Dakota State U.,2,218,218,160,48,10,218,157,113,35,9,155,61,47,13,1
10647,r221,All institutions<sup>a</sup> -> A. T. Still U.,All institutions<sup>a</sup>,A. T. Still U.,2,220,211,0,0,211,218,157,0,0,157,167,54,0,0,54
10647,r222,All institutions<sup>a</sup> -> William and Mary,All institutions<sup>a</sup>,William and Mary,2,221,210,210,0,0,198,204,204,0,0,312,6,6,0,0
10647,r223,All institutions<sup>a</sup> -> Cleveland State U.,All institutions<sup>a</sup>,Cleveland State U.,2,221,210,119,91,0,217,159,89,70,0,170,51,30,21,0
10647,r224,All institutions<sup>a</sup> -> Rowan U.,All institutions<sup>a</sup>,Rowan U.,2,223,208,106,102,0,209,179,84,95,0,220,29,22,7,0
10647,r225,All institutions<sup>a</sup> -> Duquesne U.,All institutions<sup>a</sup>,Duquesne U.,2,224,202,102,0,100,202,192,97,0,95,284,10,5,0,5
10647,r226,All institutions<sup>a</sup> -> Dakota State U.,All institutions<sup>a</sup>,Dakota State U.,2,224,202,202,0,0,247,110,110,0,0,119,92,92,0,0
10647,r227,All institutions<sup>a</sup> -> Texas State U.,All institutions<sup>a</sup>,Texas State U.,2,226,200,157,43,0,221,153,120,33,0,176,47,37,10,0
10647,r228,All institutions<sup>a</sup> -> Clarkson U.,All institutions<sup>a</sup>,Clarkson U.,2,227,198,82,116,0,205,187,79,108,0,279,11,3,8,0
10647,r229,All institutions<sup>a</sup> -> American U.,All institutions<sup>a</sup>,American U.,2,227,198,198,0,0,207,186,186,0,0,273,12,12,0,0
10647,r230,All institutions<sup>a</sup> -> Miami U.,All institutions<sup>a</sup>,Miami U.,2,229,196,196,0,0,203,190,190,0,0,312,6,6,0,0
10647,r231,All institutions<sup>a</sup> -> Seton Hall U.,All institutions<sup>a</sup>,Seton Hall U.,2,230,192,91,0,101,330,26,26,0,0,64,166,65,0,101
10647,r232,All institutions<sup>a</sup> -> Andrews U.,All institutions<sup>a</sup>,Andrews U.,2,231,188,48,0,140,235,130,45,0,85,158,58,3,0,55
10647,r233,All institutions<sup>a</sup> -> Idaho State U.,All institutions<sup>a</sup>,Idaho State U.,2,232,185,99,46,40,249,105,64,15,26,132,80,35,31,14
10647,r234,"All institutions<sup>a</sup> -> Loyola U., Chicago",All institutions<sup>a</sup>,"Loyola U., Chicago",2,233,184,184,0,0,209,179,179,0,0,316,5,5,0,0
10647,r235,All institutions<sup>a</sup> -> U. Tulsa,All institutions<sup>a</sup>,U. Tulsa,2,233,184,115,69,0,216,162,95,67,0,242,22,20,2,0
10647,r236,All institutions<sup>a</sup> -> U. Northern Colorado,All institutions<sup>a</sup>,U. Northern Colorado,2,235,183,109,0,74,269,76,59,0,17,108,107,50,0,57
10647,r237,"All institutions<sup>a</sup> -> U. Missouri, Saint Louis",All institutions<sup>a</sup>,"U. Missouri, Saint Louis",2,236,182,162,0,20,240,124,121,0,3,158,58,41,0,17
10647,r238,"All institutions<sup>a</sup> -> U. Massachusetts, Dartmouth",All institutions<sup>a</sup>,"U. Massachusetts, Dartmouth",2,237,180,79,76,25,265,83,39,41,3,113,97,40,35,22
10647,r239,All institutions<sup>a</sup> -> Long Island U.,All institutions<sup>a</sup>,Long Island U.,2,238,179,154,0,25,276,70,62,0,8,104,109,92,0,17
10647,r240,All institutions<sup>a</sup> -> U. Arkansas for Medical Sciences,All institutions<sup>a</sup>,U. Arkansas for Medical Sciences,2,239,178,88,0,90,244,115,74,0,41,151,63,14,0,49
10647,r241,All institutions<sup>a</sup> -> U. South Alabama,All institutions<sup>a</sup>,U. South Alabama,2,240,177,130,35,12,228,135,105,21,9,183,42,25,14,3
10647,r242,All institutions<sup>a</sup> -> East Tennessee State U.,All institutions<sup>a</sup>,East Tennessee State U.,2,241,169,81,0,88,245,114,61,0,53,164,55,20,0,35
10647,r243,All institutions<sup>a</sup> -> Louisiana Tech U.,All institutions<sup>a</sup>,Louisiana Tech U.,2,242,167,91,76,0,232,132,68,64,0,199,35,23,12,0
10647,r244,"All institutions<sup>a</sup> -> SUNY, C. of Environmental Science and Forestry",All institutions<sup>a</sup>,"SUNY, C. of Environmental Science and Forestry",2,242,167,135,32,0,267,82,69,13,0,125,85,66,19,0
10647,r245,All institutions<sup>a</sup> -> Marymount U.,All institutions<sup>a</sup>,Marymount U.,2,244,165,165,0,0,264,86,86,0,0,133,79,79,0,0
10647,r246,All institutions<sup>a</sup> -> Uniformed Services U. of the Health Sciences,All institutions<sup>a</sup>,Uniformed Services U. of the Health Sciences,2,245,163,131,0,32,220,154,131,0,23,291,9,0,0,9
10647,r247,"All institutions<sup>a</sup> -> U. Puerto Rico, Mayaguez",All institutions<sup>a</sup>,"U. Puerto Rico, Mayaguez",2,246,162,55,107,0,223,150,51,99,0,273,12,4,8,0
10647,r248,All institutions<sup>a</sup> -> Catholic U. of America,All institutions<sup>a</sup>,Catholic U. of America,2,247,160,90,70,0,227,137,73,64,0,237,23,17,6,0
10647,r249,"All institutions<sup>a</sup> -> St. John's U., Queens",All institutions<sup>a</sup>,"St. John's U., Queens",2,248,159,72,0,87,238,127,56,0,71,208,32,16,0,16
10647,r250,All institutions<sup>a</sup> -> U. New Orleans,All institutions<sup>a</sup>,U. New Orleans,2,249,156,100,56,0,252,100,64,36,0,163,56,36,20,0
10647,r251,All institutions<sup>a</sup> -> Medical U. South Carolina,All institutions<sup>a</sup>,Medical U. South Carolina,2,250,152,121,0,31,232,132,120,0,12,249,20,1,0,19
10647,r252,"All institutions<sup>a</sup> -> U. Puerto Rico, Medical Sciences Campus",All institutions<sup>a</sup>,"U. Puerto Rico, Medical Sciences Campus",2,251,151,50,0,101,228,135,49,0,86,262,16,1,0,15
10647,r253,All institutions<sup>a</sup> -> Embry-Riddle Aeronautical U.,All institutions<sup>a</sup>,Embry-Riddle Aeronautical U.,2,252,150,15,135,0,226,140,15,125,0,284,10,0,10,0
10647,r254,All institutions<sup>a</sup> -> Rush U.,All institutions<sup>a</sup>,Rush U.,2,252,150,66,0,84,251,104,64,0,40,179,46,2,0,44
10647,r255,All institutions<sup>a</sup> -> Florida A&M U.,All institutions<sup>a</sup>,Florida A&M U.,2,254,149,54,50,45,230,134,43,50,41,265,15,11,0,4
10647,r256,All institutions<sup>a</sup> -> East Carolina U.,All institutions<sup>a</sup>,East Carolina U.,2,255,147,110,0,37,247,110,106,0,4,196,37,4,0,33
10647,r257,All institutions<sup>a</sup> -> Tennessee Technological U.,All institutions<sup>a</sup>,Tennessee Technological U.,2,256,145,25,120,0,323,31,2,29,0,99,114,23,91,0
10647,r258,All institutions<sup>a</sup> -> Butler U.,All institutions<sup>a</sup>,Butler U.,2,257,143,0,0,143,345,18,0,0,18,92,125,0,0,125
10647,r259,All institutions<sup>a</sup> -> Central Michigan U.,All institutions<sup>a</sup>,Central Michigan U.,2,258,142,142,0,0,282,59,59,0,0,130,83,83,0,0
10647,r260,All institutions<sup>a</sup> -> U. Bridgeport,All institutions<sup>a</sup>,U. Bridgeport,2,258,142,0,24,118,350,17,0,11,6,92,125,0,13,112
10647,r261,All institutions<sup>a</sup> -> DePaul U.,All institutions<sup>a</sup>,DePaul U.,2,260,140,140,0,0,301,42,42,0,0,112,98,98,0,0
10647,r262,All institutions<sup>a</sup> -> Wright State U.,All institutions<sup>a</sup>,Wright State U.,2,261,139,67,72,0,252,100,56,44,0,191,39,11,28,0
10647,r263,All institutions<sup>a</sup> -> U. Dayton,All institutions<sup>a</sup>,U. Dayton,2,262,134,18,116,0,230,134,18,116,0,356,0,0,0,0
10647,r264,"All institutions<sup>a</sup> -> SUNY, Upstate Medical U.",All institutions<sup>a</sup>,"SUNY, Upstate Medical U.",2,263,133,133,0,0,232,132,132,0,0,344,1,1,0,0
10647,r265,"All institutions<sup>a</sup> -> CUNY, City C.",All institutions<sup>a</sup>,"CUNY, City C.",2,263,133,0,133,0,235,130,0,130,0,326,3,0,3,0
10647,r266,All institutions<sup>a</sup> -> New Mexico Institute of Mining and Technology,All institutions<sup>a</sup>,New Mexico Institute of Mining and Technology,2,263,133,79,54,0,249,105,67,38,0,226,28,12,16,0
10647,r267,All institutions<sup>a</sup> -> Thomas Jefferson U.,All institutions<sup>a</sup>,Thomas Jefferson U.,2,266,129,129,0,0,237,129,129,0,0,356,0,0,0,0
10647,r268,All institutions<sup>a</sup> -> Ball State U.,All institutions<sup>a</sup>,Ball State U.,2,267,127,127,0,0,269,76,76,0,0,170,51,51,0,0
10647,r269,All institutions<sup>a</sup> -> Air Force Institute of Technology,All institutions<sup>a</sup>,Air Force Institute of Technology,2,268,124,24,100,0,257,94,17,77,0,216,30,7,23,0
10647,r270,"All institutions<sup>a</sup> -> SUNY, Downstate Medical Center",All institutions<sup>a</sup>,"SUNY, Downstate Medical Center",2,269,123,47,6,70,285,54,45,6,3,147,69,2,0,67
10647,r271,All institutions<sup>a</sup> -> Clark U.,All institutions<sup>a</sup>,Clark U.,2,270,121,121,0,0,242,118,118,0,0,326,3,3,0,0
10647,r272,All institutions<sup>a</sup> -> Pardee RAND Graduate School,All institutions<sup>a</sup>,Pardee RAND Graduate School,2,271,120,120,0,0,241,120,120,0,0,356,0,0,0,0
10647,r273,All institutions<sup>a</sup> -> Barry U.,All institutions<sup>a</sup>,Barry U.,2,271,120,49,0,71,301,42,24,0,18,136,78,25,0,53
10647,r274,All institutions<sup>a</sup> -> Massachusetts C. of Pharmacy and Health Sciences,All institutions<sup>a</sup>,Massachusetts C. of Pharmacy and Health Sciences,2,273,115,12,0,103,319,33,12,0,21,131,82,0,0,82
10647,r275,"All institutions<sup>a</sup> -> U. Nebraska, Omaha",All institutions<sup>a</sup>,"U. Nebraska, Omaha",2,274,110,110,0,0,286,53,53,0,0,161,57,57,0,0
10647,r276,All institutions<sup>a</sup> -> Pace U.,All institutions<sup>a</sup>,Pace U.,2,274,110,71,0,39,293,49,26,0,23,155,61,45,0,16
10647,r277,All institutions<sup>a</sup> -> Augusta U.,All institutions<sup>a</sup>,Augusta U.,2,276,109,92,0,17,252,100,88,0,12,291,9,4,0,5
10647,r278,All institutions<sup>a</sup> -> Hofstra U.,All institutions<sup>a</sup>,Hofstra U.,2,276,109,109,0,0,255,97,97,0,0,273,12,12,0,0
10647,r279,All institutions<sup>a</sup> -> Southern U. and A&M C.,All institutions<sup>a</sup>,Southern U. and A&M C.,2,278,108,104,0,4,286,53,51,0,2,164,55,53,0,2
10647,r280,All institutions<sup>a</sup> -> Villanova U.,All institutions<sup>a</sup>,Villanova U.,2,279,106,0,91,15,269,76,0,67,9,216,30,0,24,6
10647,r281,All institutions<sup>a</sup> -> Tennessee State U.,All institutions<sup>a</sup>,Tennessee State U.,2,279,106,82,24,0,277,69,58,11,0,196,37,24,13,0
10647,r282,All institutions<sup>a</sup> -> Seattle Pacific U.,All institutions<sup>a</sup>,Seattle Pacific U.,2,281,102,102,0,0,281,61,61,0,0,185,41,41,0,0
10647,r283,All institutions<sup>a</sup> -> U. Indianapolis,All institutions<sup>a</sup>,U. Indianapolis,2,282,100,0,0,100,378,6,0,0,6,116,94,0,0,94
10647,r284,All institutions<sup>a</sup> -> Memorial Sloan Kettering Cancer Center,All institutions<sup>a</sup>,Memorial Sloan Kettering Cancer Center,2,283,97,97,0,0,255,97,97,0,0,356,0,0,0,0
10647,r285,"All institutions<sup>a</sup> -> U. Michigan, Flint",All institutions<sup>a</sup>,"U. Michigan, Flint",2,283,97,0,0,97,262,89,0,0,89,300,8,0,0,8
10647,r286,All institutions<sup>a</sup> -> Yeshiva U.,All institutions<sup>a</sup>,Yeshiva U.,2,285,95,95,0,0,279,65,65,0,0,216,30,30,0,0
10647,r287,"All institutions<sup>a</sup> -> U. North Texas, Health Science Center",All institutions<sup>a</sup>,"U. North Texas, Health Science Center",2,286,94,83,0,11,257,94,83,0,11,356,0,0,0,0
10647,r288,All institutions<sup>a</sup> -> Saint Joseph's U.<sup>c</sup>,All institutions<sup>a</sup>,Saint Joseph's U.<sup>c</sup>,2,286,94,71,0,23,291,50,42,0,8,181,44,29,0,15
10647,r289,"All institutions<sup>a</sup> -> City of Hope, Irell and Manella Graduate School of Biological Sciences",All institutions<sup>a</sup>,"City of Hope, Irell and Manella Graduate School of Biological Sciences",2,288,91,91,0,0,259,91,91,0,0,356,0,0,0,0
10647,r290,All institutions<sup>a</sup> -> National Louis U.,All institutions<sup>a</sup>,National Louis U.,2,289,88,88,0,0,283,57,57,0,0,209,31,31,0,0
10647,r291,All institutions<sup>a</sup> -> Texas Christian U.,All institutions<sup>a</sup>,Texas Christian U.,2,290,85,72,0,13,265,83,71,0,12,336,2,1,0,1
10647,r292,All institutions<sup>a</sup> -> Middle Tennessee State U.,All institutions<sup>a</sup>,Middle Tennessee State U.,2,290,85,85,0,0,393,0,0,0,0,125,85,85,0,0
10647,r293,All institutions<sup>a</sup> -> Illinois State U.,All institutions<sup>a</sup>,Illinois State U.,2,292,83,70,0,13,278,66,66,0,0,259,17,4,0,13
10647,r294,All institutions<sup>a</sup> -> Texas A&M U.-Corpus Christi,All institutions<sup>a</sup>,Texas A&M U.-Corpus Christi,2,293,79,79,0,0,273,72,72,0,0,307,7,7,0,0
10647,r295,All institutions<sup>a</sup> -> South Dakota School of Mines and Technology,All institutions<sup>a</sup>,South Dakota School of Mines and Technology,2,293,79,23,56,0,274,71,20,51,0,300,8,3,5,0
10647,r296,All institutions<sup>a</sup> -> Jackson State U.,All institutions<sup>a</sup>,Jackson State U.,2,293,79,59,20,0,325,29,21,8,0,173,50,38,12,0
10647,r297,All institutions<sup>a</sup> -> Naval Postgraduate School,All institutions<sup>a</sup>,Naval Postgraduate School,2,296,77,38,39,0,268,77,38,39,0,356,0,0,0,0
10647,r298,All institutions<sup>a</sup> -> Harrisburg U. of Science and Technology,All institutions<sup>a</sup>,Harrisburg U. of Science and Technology,2,297,76,76,0,0,272,73,73,0,0,326,3,3,0,0
10647,r299,All institutions<sup>a</sup> -> Chapman U.,All institutions<sup>a</sup>,Chapman U.,2,297,76,48,0,28,305,41,21,0,20,199,35,27,0,8
10647,r300,All institutions<sup>a</sup> -> U. of the Pacific,All institutions<sup>a</sup>,U. of the Pacific,2,299,74,29,0,45,342,19,14,0,5,164,55,15,0,40
10647,r301,All institutions<sup>a</sup> -> Arkansas State U.,All institutions<sup>a</sup>,Arkansas State U.,2,300,73,73,0,0,301,42,42,0,0,209,31,31,0,0
10647,r302,"All institutions<sup>a</sup> -> SUNY, Polytechnic Institute",All institutions<sup>a</sup>,"SUNY, Polytechnic Institute",2,300,73,7,66,0,313,38,6,32,0,199,35,1,34,0
10647,r303,All institutions<sup>a</sup> -> Eastern Virginia Medical School,All institutions<sup>a</sup>,Eastern Virginia Medical School,2,302,72,0,0,72,311,39,0,0,39,206,33,0,0,33
10647,r304,All institutions<sup>a</sup> -> Kennesaw State U.,All institutions<sup>a</sup>,Kennesaw State U.,2,303,71,57,14,0,298,45,31,14,0,230,26,26,0,0
10647,r305,All institutions<sup>a</sup> -> Santa Clara U.,All institutions<sup>a</sup>,Santa Clara U.,2,304,66,0,66,0,324,30,0,30,0,198,36,0,36,0
10647,r306,All institutions<sup>a</sup> -> U. Texas Rio Grande Valley,All institutions<sup>a</sup>,U. Texas Rio Grande Valley,2,305,65,65,0,0,289,52,52,0,0,268,13,13,0,0
10647,r307,All institutions<sup>a</sup> -> Lamar U.,All institutions<sup>a</sup>,Lamar U.,2,305,65,0,65,0,316,34,0,34,0,209,31,0,31,0
10647,r308,All institutions<sup>a</sup> -> Wesleyan U.,All institutions<sup>a</sup>,Wesleyan U.,2,307,63,63,0,0,280,63,63,0,0,356,0,0,0,0
10647,r309,All institutions<sup>a</sup> -> Mercer U.,All institutions<sup>a</sup>,Mercer U.,2,308,62,0,0,62,286,53,0,0,53,291,9,0,0,9
10647,r310,All institutions<sup>a</sup> -> Morehouse School of Medicine,All institutions<sup>a</sup>,Morehouse School of Medicine,2,309,61,43,0,18,283,57,41,0,16,322,4,2,0,2
10647,r311,All institutions<sup>a</sup> -> Towson U.,All institutions<sup>a</sup>,Towson U.,2,310,59,59,0,0,308,40,40,0,0,253,19,19,0,0
10647,r312,All institutions<sup>a</sup> -> Clark Atlanta U.,All institutions<sup>a</sup>,Clark Atlanta U.,2,310,59,59,0,0,321,32,32,0,0,229,27,27,0,0
10647,r313,All institutions<sup>a</sup> -> Endicott C.,All institutions<sup>a</sup>,Endicott C.,2,310,59,45,0,14,340,20,20,0,0,191,39,25,0,14
10647,r314,All institutions<sup>a</sup> -> Antioch U.,All institutions<sup>a</sup>,Antioch U.,2,313,57,57,0,0,315,35,35,0,0,242,22,22,0,0
10647,r315,All institutions<sup>a</sup> -> Bowie State U.,All institutions<sup>a</sup>,Bowie State U.,2,314,54,54,0,0,335,23,23,0,0,209,31,31,0,0
10647,r316,"All institutions<sup>a</sup> -> U. Texas, Tyler",All institutions<sup>a</sup>,"U. Texas, Tyler",2,314,54,21,0,33,337,21,20,0,1,206,33,1,0,32
10647,r317,All institutions<sup>a</sup> -> Marshall U.,All institutions<sup>a</sup>,Marshall U.,2,316,53,53,0,0,290,51,51,0,0,336,2,2,0,0
10647,r318,All institutions<sup>a</sup> -> Tuskegee U.,All institutions<sup>a</sup>,Tuskegee U.,2,316,53,46,7,0,291,50,43,7,0,326,3,3,0,0
10647,r319,All institutions<sup>a</sup> -> James Madison U.,All institutions<sup>a</sup>,James Madison U.,2,318,52,52,0,0,301,42,42,0,0,284,10,10,0,0
10647,r320,All institutions<sup>a</sup> -> Texas A&M U.-Kingsville,All institutions<sup>a</sup>,Texas A&M U.-Kingsville,2,318,52,14,38,0,328,27,12,15,0,232,25,2,23,0
10647,r321,All institutions<sup>a</sup> -> Delaware State U.<sup>d</sup>,All institutions<sup>a</sup>,Delaware State U.<sup>d</sup>,2,320,51,51,0,0,296,46,46,0,0,316,5,5,0,0
10647,r322,All institutions<sup>a</sup> -> Cold Spring Harbor Laboratory,All institutions<sup>a</sup>,Cold Spring Harbor Laboratory,2,321,49,49,0,0,293,49,49,0,0,356,0,0,0,0
10647,r323,All institutions<sup>a</sup> -> Van Andel Institute,All institutions<sup>a</sup>,Van Andel Institute,2,322,48,48,0,0,295,48,48,0,0,356,0,0,0,0
10647,r324,All institutions<sup>a</sup> -> Azusa Pacific U.,All institutions<sup>a</sup>,Azusa Pacific U.,2,322,48,0,0,48,311,39,0,0,39,291,9,0,0,9
10647,r325,All institutions<sup>a</sup> -> Suffolk U.,All institutions<sup>a</sup>,Suffolk U.,2,322,48,48,0,0,328,27,27,0,0,247,21,21,0,0
10647,r326,All institutions<sup>a</sup> -> Stephen F. Austin State U.,All institutions<sup>a</sup>,Stephen F. Austin State U.,2,325,47,47,0,0,331,25,25,0,0,242,22,22,0,0
10647,r327,All institutions<sup>a</sup> -> Albany Medical C.,All institutions<sup>a</sup>,Albany Medical C.,2,326,46,46,0,0,296,46,46,0,0,356,0,0,0,0
10647,r328,All institutions<sup>a</sup> -> Sam Houston State U.,All institutions<sup>a</sup>,Sam Houston State U.,2,326,46,46,0,0,335,23,23,0,0,237,23,23,0,0
10647,r329,All institutions<sup>a</sup> -> Niagara U.,All institutions<sup>a</sup>,Niagara U.,2,326,46,46,0,0,350,17,17,0,0,220,29,29,0,0
10647,r330,All institutions<sup>a</sup> -> Sanford-Burnham Medical Research Institute,All institutions<sup>a</sup>,Sanford-Burnham Medical Research Institute,2,329,44,44,0,0,299,44,44,0,0,356,0,0,0,0
10647,r331,All institutions<sup>a</sup> -> Gallaudet U.,All institutions<sup>a</sup>,Gallaudet U.,2,329,44,35,0,9,333,24,21,0,3,249,20,14,0,6
10647,r332,"All institutions<sup>a</sup> -> U. Maryland, Eastern Shore",All institutions<sup>a</sup>,"U. Maryland, Eastern Shore",2,329,44,35,0,9,368,9,5,0,4,199,35,30,0,5
10647,r333,All institutions<sup>a</sup> -> U. San Diego,All institutions<sup>a</sup>,U. San Diego,2,329,44,0,0,44,381,5,0,0,5,191,39,0,0,39
10647,r334,All institutions<sup>a</sup> -> U. del Turabo,All institutions<sup>a</sup>,U. del Turabo,2,333,43,43,0,0,300,43,43,0,0,356,0,0,0,0
10647,r335,All institutions<sup>a</sup> -> Biola U.,All institutions<sup>a</sup>,Biola U.,2,333,43,43,0,0,308,40,40,0,0,326,3,3,0,0
10647,r336,All institutions<sup>a</sup> -> Creighton U.,All institutions<sup>a</sup>,Creighton U.,2,335,42,42,0,0,305,41,41,0,0,344,1,1,0,0
10647,r337,"All institutions<sup>a</sup> -> California State U., Los Angeles",All institutions<sup>a</sup>,"California State U., Los Angeles",2,336,41,0,0,41,305,41,0,0,41,356,0,0,0,0
10647,r338,All institutions<sup>a</sup> -> Simmons U.,All institutions<sup>a</sup>,Simmons U.,2,336,41,26,0,15,393,0,0,0,0,185,41,26,0,15
10647,r339,"All institutions<sup>a</sup> -> Toyota Technological Institute, Chicago",All institutions<sup>a</sup>,"Toyota Technological Institute, Chicago",2,338,40,40,0,0,308,40,40,0,0,356,0,0,0,0
10647,r340,All institutions<sup>a</sup> -> Widener U.,All institutions<sup>a</sup>,Widener U.,2,339,39,0,0,39,354,16,0,0,16,237,23,0,0,23
10647,r341,All institutions<sup>a</sup> -> Molloy C.,All institutions<sup>a</sup>,Molloy C.,2,339,39,0,0,39,393,0,0,0,0,191,39,0,0,39
10647,r342,"All institutions<sup>a</sup> -> U. Tennessee, Chattanooga",All institutions<sup>a</sup>,"U. Tennessee, Chattanooga",2,341,38,38,0,0,340,20,20,0,0,257,18,18,0,0
10647,r343,All institutions<sup>a</sup> -> Cedars-Sinai Medical Center,All institutions<sup>a</sup>,Cedars-Sinai Medical Center,2,342,37,37,0,0,314,37,37,0,0,356,0,0,0,0
10647,r344,All institutions<sup>a</sup> -> Texas Southern U.,All institutions<sup>a</sup>,Texas Southern U.,2,342,37,19,0,18,326,28,12,0,16,291,9,7,0,2
10647,r345,All institutions<sup>a</sup> -> Western New England U.,All institutions<sup>a</sup>,Western New England U.,2,344,36,35,1,0,370,8,7,1,0,226,28,28,0,0
10647,r346,"All institutions<sup>a</sup> -> U. North Carolina, Wilmington",All institutions<sup>a</sup>,"U. North Carolina, Wilmington",2,345,35,35,0,0,316,34,34,0,0,344,1,1,0,0
10647,r347,All institutions<sup>a</sup> -> U. Central Arkansas,All institutions<sup>a</sup>,U. Central Arkansas,2,345,35,26,0,9,345,18,18,0,0,259,17,8,0,9
10647,r348,All institutions<sup>a</sup> -> Robert Morris U.,All institutions<sup>a</sup>,Robert Morris U.,2,345,35,35,0,0,393,0,0,0,0,199,35,35,0,0
10647,r349,All institutions<sup>a</sup> -> New York Medical C.,All institutions<sup>a</sup>,New York Medical C.,2,348,34,34,0,0,316,34,34,0,0,356,0,0,0,0
10647,r350,All institutions<sup>a</sup> -> U. West Georgia,All institutions<sup>a</sup>,U. West Georgia,2,348,34,34,0,0,355,15,15,0,0,253,19,19,0,0
10647,r351,All institutions<sup>a</sup> -> Indiana U. Pennsylvania,All institutions<sup>a</sup>,Indiana U. Pennsylvania,2,348,34,34,0,0,357,14,14,0,0,249,20,20,0,0
10647,r352,All institutions<sup>a</sup> -> Meharry Medical C.,All institutions<sup>a</sup>,Meharry Medical C.,2,351,33,33,0,0,319,33,33,0,0,356,0,0,0,0
10647,r353,"All institutions<sup>a</sup> -> Oklahoma State U., Center for Health Sciences",All institutions<sup>a</sup>,"Oklahoma State U., Center for Health Sciences",2,351,33,33,0,0,357,14,14,0,0,253,19,19,0,0
10647,r354,All institutions<sup>a</sup> -> U. New Haven,All institutions<sup>a</sup>,U. New Haven,2,353,32,0,6,26,321,32,0,6,26,356,0,0,0,0
10647,r355,All institutions<sup>a</sup> -> Bryn Mawr C.,All institutions<sup>a</sup>,Bryn Mawr C.,2,354,31,31,0,0,333,24,24,0,0,307,7,7,0,0
10647,r356,"All institutions<sup>a</sup> -> U. Louisiana, Monroe",All institutions<sup>a</sup>,"U. Louisiana, Monroe",2,355,30,7,0,23,331,25,6,0,19,316,5,1,0,4
10647,r357,All institutions<sup>a</sup> -> Indiana State U.,All institutions<sup>a</sup>,Indiana State U.,2,356,29,29,0,0,342,19,19,0,0,284,10,10,0,0
10647,r358,All institutions<sup>a</sup> -> Keck Graduate Institute,All institutions<sup>a</sup>,Keck Graduate Institute,2,357,28,28,0,0,326,28,28,0,0,356,0,0,0,0
10647,r359,All institutions<sup>a</sup> -> Norfolk State U.,All institutions<sup>a</sup>,Norfolk State U.,2,358,26,26,0,0,337,21,21,0,0,316,5,5,0,0
10647,r360,All institutions<sup>a</sup> -> Tarleton State U.,All institutions<sup>a</sup>,Tarleton State U.,2,359,25,25,0,0,337,21,21,0,0,322,4,4,0,0
10647,r361,All institutions<sup>a</sup> -> Montana Tech of U. Montana,All institutions<sup>a</sup>,Montana Tech of U. Montana,2,360,24,14,10,0,363,11,5,6,0,268,13,9,4,0
10647,r362,All institutions<sup>a</sup> -> U. of the District of Columbia,All institutions<sup>a</sup>,U. of the District of Columbia,2,360,24,24,0,0,363,11,11,0,0,268,13,13,0,0
10647,r363,All institutions<sup>a</sup> -> Polytechnic U. Puerto Rico,All institutions<sup>a</sup>,Polytechnic U. Puerto Rico,2,360,24,0,24,0,382,4,0,4,0,249,20,0,20,0
10647,r364,All institutions<sup>a</sup> -> New Jersey City U.,All institutions<sup>a</sup>,New Jersey City U.,2,360,24,24,0,0,393,0,0,0,0,235,24,24,0,0
10647,r365,All institutions<sup>a</sup> -> Texas A&M U.-Commerce,All institutions<sup>a</sup>,Texas A&M U.-Commerce,2,364,23,23,0,0,377,7,7,0,0,262,16,16,0,0
10647,r366,All institutions<sup>a</sup> -> Hampton U.,All institutions<sup>a</sup>,Hampton U.,2,365,22,10,0,12,357,14,9,0,5,300,8,1,0,7
10647,r367,"All institutions<sup>a</sup> -> U. Alaska, Anchorage",All institutions<sup>a</sup>,"U. Alaska, Anchorage",2,365,22,22,0,0,361,12,12,0,0,284,10,10,0,0
10647,r368,All institutions<sup>a</sup> -> Xavier U.,All institutions<sup>a</sup>,Xavier U.,2,365,22,0,0,22,393,0,0,0,0,242,22,0,0,22
10647,r369,All institutions<sup>a</sup> -> Drew U.,All institutions<sup>a</sup>,Drew U.,2,368,21,0,0,21,370,8,0,0,8,268,13,0,0,13
10647,r370,All institutions<sup>a</sup> -> U. Dallas,All institutions<sup>a</sup>,U. Dallas,2,369,20,20,0,0,345,18,18,0,0,336,2,2,0,0
10647,r371,All institutions<sup>a</sup> -> Maharishi U. of Management,All institutions<sup>a</sup>,Maharishi U. of Management,2,370,19,19,0,0,342,19,19,0,0,356,0,0,0,0
10647,r372,All institutions<sup>a</sup> -> Springfield C.,All institutions<sup>a</sup>,Springfield C.,2,370,19,0,0,19,345,18,0,0,18,344,1,0,0,1
10647,r373,All institutions<sup>a</sup> -> American Museum of Natural History,All institutions<sup>a</sup>,American Museum of Natural History,2,372,18,18,0,0,345,18,18,0,0,356,0,0,0,0
10647,r374,All institutions<sup>a</sup> -> New York Institute of Technology,All institutions<sup>a</sup>,New York Institute of Technology,2,373,17,3,6,8,350,17,3,6,8,356,0,0,0,0
10647,r375,All institutions<sup>a</sup> -> U. Central del Caribe,All institutions<sup>a</sup>,U. Central del Caribe,2,373,17,17,0,0,350,17,17,0,0,356,0,0,0,0
10647,r376,All institutions<sup>a</sup> -> Alabama State U.,All institutions<sup>a</sup>,Alabama State U.,2,373,17,17,0,0,370,8,8,0,0,291,9,9,0,0
10647,r377,All institutions<sup>a</sup> -> Wilkes U.,All institutions<sup>a</sup>,Wilkes U.,2,373,17,0,0,17,393,0,0,0,0,259,17,0,0,17
10647,r378,All institutions<sup>a</sup> -> Alfred U.,All institutions<sup>a</sup>,Alfred U.,2,377,16,0,16,0,355,15,0,15,0,344,1,0,1,0
10647,r379,All institutions<sup>a</sup> -> Lawrence Technological U.,All institutions<sup>a</sup>,Lawrence Technological U.,2,377,16,0,16,0,390,1,0,1,0,265,15,0,15,0
10647,r380,All institutions<sup>a</sup> -> U. Northern Iowa,All institutions<sup>a</sup>,U. Northern Iowa,2,379,15,15,0,0,361,12,12,0,0,326,3,3,0,0
10647,r381,All institutions<sup>a</sup> -> North Carolina Central U.,All institutions<sup>a</sup>,North Carolina Central U.,2,379,15,15,0,0,365,10,10,0,0,316,5,5,0,0
10647,r382,All institutions<sup>a</sup> -> Virginia State U.,All institutions<sup>a</sup>,Virginia State U.,2,379,15,15,0,0,370,8,8,0,0,307,7,7,0,0
10647,r383,"All institutions<sup>a</sup> -> SUNY, C. of Optometry",All institutions<sup>a</sup>,"SUNY, C. of Optometry",2,382,14,14,0,0,357,14,14,0,0,356,0,0,0,0
10647,r384,All institutions<sup>a</sup> -> U. North Alabama,All institutions<sup>a</sup>,U. North Alabama,2,382,14,0,0,14,368,9,0,0,9,316,5,0,0,5
10647,r385,All institutions<sup>a</sup> -> Lipscomb U.,All institutions<sup>a</sup>,Lipscomb U.,2,382,14,14,0,0,386,3,3,0,0,279,11,11,0,0
10647,r386,All institutions<sup>a</sup> -> Clarion U. Pennsylvania<sup>e</sup>,All institutions<sup>a</sup>,Clarion U. Pennsylvania<sup>e</sup>,2,382,14,14,0,0,393,0,0,0,0,267,14,14,0,0
10647,r387,All institutions<sup>a</sup> -> Oklahoma City U.,All institutions<sup>a</sup>,Oklahoma City U.,2,386,13,0,0,13,365,10,0,0,10,326,3,0,0,3
10647,r388,All institutions<sup>a</sup> -> Salus U.,All institutions<sup>a</sup>,Salus U.,2,386,13,13,0,0,365,10,10,0,0,326,3,3,0,0
10647,r389,All institutions<sup>a</sup> -> West Texas A&M U.,All institutions<sup>a</sup>,West Texas A&M U.,2,388,12,12,0,0,370,8,8,0,0,322,4,4,0,0
10647,r390,"All institutions<sup>a</sup> -> Northeastern Ohio Universities, C. of Medicine",All institutions<sup>a</sup>,"Northeastern Ohio Universities, C. of Medicine",2,388,12,0,0,12,382,4,0,0,4,300,8,0,0,8
10647,r391,All institutions<sup>a</sup> -> Coastal Carolina U.,All institutions<sup>a</sup>,Coastal Carolina U.,2,390,11,11,0,0,390,1,1,0,0,284,10,10,0,0
10647,r392,All institutions<sup>a</sup> -> Youngstown State U.,All institutions<sup>a</sup>,Youngstown State U.,2,391,10,10,0,0,370,8,8,0,0,336,2,2,0,0
10647,r393,All institutions<sup>a</sup> -> Elmezzi Graduate School of Molecular Medicine,All institutions<sup>a</sup>,Elmezzi Graduate School of Molecular Medicine,2,392,8,8,0,0,370,8,8,0,0,356,0,0,0,0
10647,r394,"All institutions<sup>a</sup> -> California State U., Long Beach",All institutions<sup>a</sup>,"California State U., Long Beach",2,393,7,0,7,0,393,0,0,0,0,307,7,0,7,0
10647,r395,All institutions<sup>a</sup> -> Angelo State U.,All institutions<sup>a</sup>,Angelo State U.,2,394,6,6,0,0,378,6,6,0,0,356,0,0,0,0
10647,r396,All institutions<sup>a</sup> -> Lake Erie C. of Osteopathic Medicine,All institutions<sup>a</sup>,Lake Erie C. of Osteopathic Medicine,2,394,6,5,0,1,378,6,5,0,1,356,0,0,0,0
10647,r397,"All institutions<sup>a</sup> -> Inter American U. Puerto Rico, San German",All institutions<sup>a</sup>,"Inter American U. Puerto Rico, San German",2,394,6,6,0,0,393,0,0,0,0,312,6,6,0,0
10647,r398,All institutions<sup>a</sup> -> Lincoln Memorial U.,All institutions<sup>a</sup>,Lincoln Memorial U.,2,397,5,5,0,0,386,3,3,0,0,336,2,2,0,0
10647,r399,"All institutions<sup>a</sup> -> Des Moines U., Osteopathic Medical Center",All institutions<sup>a</sup>,"Des Moines U., Osteopathic Medical Center",2,398,4,4,0,0,382,4,4,0,0,356,0,0,0,0
10647,r400,All institutions<sup>a</sup> -> Northern Kentucky U.,All institutions<sup>a</sup>,Northern Kentucky U.,2,398,4,0,0,4,382,4,0,0,4,356,0,0,0,0
10647,r401,All institutions<sup>a</sup> -> U. of the Incarnate Word,All institutions<sup>a</sup>,U. of the Incarnate Word,2,398,4,4,0,0,386,3,3,0,0,344,1,1,0,0
10647,r402,All institutions<sup>a</sup> -> Western Illinois U.,All institutions<sup>a</sup>,Western Illinois U.,2,398,4,4,0,0,389,2,2,0,0,336,2,2,0,0
10647,r403,"All institutions<sup>a</sup> -> U. Hawaii, Hilo",All institutions<sup>a</sup>,"U. Hawaii, Hilo",2,398,4,0,0,4,390,1,0,0,1,326,3,0,0,3
10647,r404,All institutions<sup>a</sup> -> Roosevelt U.,All institutions<sup>a</sup>,Roosevelt U.,2,398,4,4,0,0,393,0,0,0,0,322,4,4,0,0
10647,r405,All institutions<sup>a</sup> -> Kean U.,All institutions<sup>a</sup>,Kean U.,2,404,1,0,0,1,393,0,0,0,0,344,1,0,0,1
