table_id,row_id,_b_state_and_department_or_agency_b_full_path,_b_state_and_department_or_agency_b_level_1,_b_state_and_department_or_agency_b_level_2,_b_state_and_department_or_agency_b_level_3,_b_state_and_department_or_agency_b_hierarchy_depth,field_all_r_d_expenditures,field_source_of_funds_federal_government,field_source_of_funds_state_and_all_othersa
9945,r001,United States<sup>b</sup>,United States<sup>b</sup>,,,1,2643991142,691149390,1952841752
9945,r002,United States<sup>b</sup> -> Alabama,United States<sup>b</sup>,Alabama,,2,88219991,10458091,77761900
9945,r003,"United States<sup>b</sup> -> Alabama -> Commerce, Department of",United States<sup>b</sup>,Alabama,"Commerce, Department of",3,63419633,0,63419633
9945,r004,"United States<sup>b</sup> -> Alabama -> Conservation and Natural Resources, Department of; Wildlife and Freshwater Fisheries Division",United States<sup>b</sup>,Alabama,"Conservation and Natural Resources, Department of; Wildlife and Freshwater Fisheries Division",3,1219039,877523,341516
9945,r005,"United States<sup>b</sup> -> Alabama -> Economic and Community Affairs, Department of",United States<sup>b</sup>,Alabama,"Economic and Community Affairs, Department of",3,1693012,0,1693012
9945,r006,"United States<sup>b</sup> -> Alabama -> Education, Department of",United States<sup>b</sup>,Alabama,"Education, Department of",3,6214729,1447475,4767254
9945,r007,"United States<sup>b</sup> -> Alabama -> Forensic Sciences, Department of",United States<sup>b</sup>,Alabama,"Forensic Sciences, Department of",3,208094,0,208094
9945,r008,United States<sup>b</sup> -> Alabama -> Geological Survey,United States<sup>b</sup>,Alabama,Geological Survey,3,3563032,1673936,1889096
9945,r009,"United States<sup>b</sup> -> Alabama -> Marine Environmental Science Consortium, Dauphin Island Sea Lab",United States<sup>b</sup>,Alabama,"Marine Environmental Science Consortium, Dauphin Island Sea Lab",3,3684864,3155227,529637
9945,r010,United States<sup>b</sup> -> Alabama -> Supercomputer Authority,United States<sup>b</sup>,Alabama,Supercomputer Authority,3,4553801,0,4553801
9945,r011,"United States<sup>b</sup> -> Alabama -> Transportation, Department of",United States<sup>b</sup>,Alabama,"Transportation, Department of",3,3663787,3303930,359857
9945,r012,United States<sup>b</sup> -> Alaska,United States<sup>b</sup>,Alaska,,2,17157228,8260099,8897129
9945,r013,United States<sup>b</sup> -> Alaska -> Energy Authority,United States<sup>b</sup>,Alaska,Energy Authority,3,231152,11754,219398
9945,r014,"United States<sup>b</sup> -> Alaska -> Environmental Conservation, Department of ",United States<sup>b</sup>,Alaska,"Environmental Conservation, Department of ",3,534187,358991,175196
9945,r015,United States<sup>b</sup> -> Alaska -> Housing Finance Corporation,United States<sup>b</sup>,Alaska,Housing Finance Corporation,3,500000,0,500000
9945,r016,"United States<sup>b</sup> -> Alaska -> Natural Resources, Department of; Division of Geological and Geophysical Surveys",United States<sup>b</sup>,Alaska,"Natural Resources, Department of; Division of Geological and Geophysical Surveys",3,9216400,1741400,7475000
9945,r017,United States<sup>b</sup> -> Alaska -> Railroad Corporation,United States<sup>b</sup>,Alaska,Railroad Corporation,3,3636619,3503272,133347
9945,r018,"United States<sup>b</sup> -> Alaska -> Transportation and Public Facilities, Department of",United States<sup>b</sup>,Alaska,"Transportation and Public Facilities, Department of",3,3038870,2644682,394188
9945,r019,United States<sup>b</sup> -> Arizona,United States<sup>b</sup>,Arizona,,2,7946421,3330756,4615665
9945,r020,"United States<sup>b</sup> -> Arizona -> Agriculture, Department of",United States<sup>b</sup>,Arizona,"Agriculture, Department of",3,1412034,1237833,174201
9945,r021,United States<sup>b</sup> -> Arizona -> Game and Fish Department,United States<sup>b</sup>,Arizona,Game and Fish Department,3,1039447,960977,78470
9945,r022,"United States<sup>b</sup> -> Arizona -> Health Services, Department of",United States<sup>b</sup>,Arizona,"Health Services, Department of",3,3518749,0,3518749
9945,r023,"United States<sup>b</sup> -> Arizona -> Juvenile Corrections, Department of ",United States<sup>b</sup>,Arizona,"Juvenile Corrections, Department of ",3,561258,0,561258
9945,r024,"United States<sup>b</sup> -> Arizona -> Transportation, Department of",United States<sup>b</sup>,Arizona,"Transportation, Department of",3,1414933,1131946,282987
9945,r025,United States<sup>b</sup> -> Arkansas,United States<sup>b</sup>,Arkansas,,2,9759708,1840818,7918890
9945,r026,United States<sup>b</sup> -> Arkansas -> Beef Council,United States<sup>b</sup>,Arkansas,Beef Council,3,50605,0,50605
9945,r027,United States<sup>b</sup> -> Arkansas -> Corn and Grain Sorghum Promotion Board,United States<sup>b</sup>,Arkansas,Corn and Grain Sorghum Promotion Board,3,984233,0,984233
9945,r028,United States<sup>b</sup> -> Arkansas -> Economic Development Commission,United States<sup>b</sup>,Arkansas,Economic Development Commission,3,1675000,0,1675000
9945,r029,United States<sup>b</sup> -> Arkansas -> Game and Fish Commission,United States<sup>b</sup>,Arkansas,Game and Fish Commission,3,1159178,958691,200487
9945,r030,"United States<sup>b</sup> -> Arkansas -> Midwest Dairy Association, Arkansas Division",United States<sup>b</sup>,Arkansas,"Midwest Dairy Association, Arkansas Division",3,10386,0,10386
9945,r031,United States<sup>b</sup> -> Arkansas -> Natural Heritage Commission,United States<sup>b</sup>,Arkansas,Natural Heritage Commission,3,160921,18735,142186
9945,r032,United States<sup>b</sup> -> Arkansas -> Rice Research and Promotion Board,United States<sup>b</sup>,Arkansas,Rice Research and Promotion Board,3,2396257,0,2396257
9945,r033,United States<sup>b</sup> -> Arkansas -> Soybean Promotion Board,United States<sup>b</sup>,Arkansas,Soybean Promotion Board,3,2207956,0,2207956
9945,r034,"United States<sup>b</sup> -> Arkansas -> Transportation, Department of",United States<sup>b</sup>,Arkansas,"Transportation, Department of",3,1079240,863392,215848
9945,r035,United States<sup>b</sup> -> Arkansas -> Wheat Promotion Board,United States<sup>b</sup>,Arkansas,Wheat Promotion Board,3,35932,0,35932
9945,r036,United States<sup>b</sup> -> California,United States<sup>b</sup>,California,,2,490081806,20301828,469779978
9945,r037,United States<sup>b</sup> -> California -> Air Resources Board,United States<sup>b</sup>,California,Air Resources Board,3,17251207,74677,17176530
9945,r038,United States<sup>b</sup> -> California -> Children and Families Commission (First 5 California),United States<sup>b</sup>,California,Children and Families Commission (First 5 California),3,7739521,0,7739521
9945,r039,"United States<sup>b</sup> -> California -> Conservation, Department of",United States<sup>b</sup>,California,"Conservation, Department of",3,1259204,402213,856991
9945,r040,"United States<sup>b</sup> -> California -> Corrections and Rehabilitation, Department of",United States<sup>b</sup>,California,"Corrections and Rehabilitation, Department of",3,2301034,0,2301034
9945,r041,United States<sup>b</sup> -> California -> Covered California,United States<sup>b</sup>,California,Covered California,3,3799165,0,3799165
9945,r042,United States<sup>b</sup> -> California -> Dairy Council,United States<sup>b</sup>,California,Dairy Council,3,50373,0,50373
9945,r043,United States<sup>b</sup> -> California -> Delta Stewardship Council,United States<sup>b</sup>,California,Delta Stewardship Council,3,5201966,955128,4246838
9945,r044,United States<sup>b</sup> -> California -> Earthquake Authority,United States<sup>b</sup>,California,Earthquake Authority,3,539832,0,539832
9945,r045,United States<sup>b</sup> -> California -> Energy Commission,United States<sup>b</sup>,California,Energy Commission,3,130400000,0,130400000
9945,r046,"United States<sup>b</sup> -> California -> Environmental Health Hazard Assessment, Office of",United States<sup>b</sup>,California,"Environmental Health Hazard Assessment, Office of",3,19844985,0,19844985
9945,r047,"United States<sup>b</sup> -> California -> Food and Agriculture, Department of",United States<sup>b</sup>,California,"Food and Agriculture, Department of",3,5012081,54256,4957825
9945,r048,"United States<sup>b</sup> -> California -> Forestry and Fire Protection, Department of",United States<sup>b</sup>,California,"Forestry and Fire Protection, Department of",3,21200000,0,21200000
9945,r049,United States<sup>b</sup> -> California -> Horse Racing Board,United States<sup>b</sup>,California,Horse Racing Board,3,710513,0,710513
9945,r050,"United States<sup>b</sup> -> California -> Housing and Community Development, Department of",United States<sup>b</sup>,California,"Housing and Community Development, Department of",3,500000,0,500000
9945,r051,United States<sup>b</sup> -> California -> Institute for Regenerative Medicine,United States<sup>b</sup>,California,Institute for Regenerative Medicine,3,122808196,0,122808196
9945,r052,United States<sup>b</sup> -> California -> Mental Health Services Oversight and Accountability Commission,United States<sup>b</sup>,California,Mental Health Services Oversight and Accountability Commission,3,2500000,0,2500000
9945,r053,"United States<sup>b</sup> -> California -> Motor Vehicles, Department of",United States<sup>b</sup>,California,"Motor Vehicles, Department of",3,1776392,0,1776392
9945,r054,"United States<sup>b</sup> -> California -> Parks And Recreation, Department of",United States<sup>b</sup>,California,"Parks And Recreation, Department of",3,1515260,0,1515260
9945,r055,"United States<sup>b</sup> -> California -> Pesticide Regulation, Department of ",United States<sup>b</sup>,California,"Pesticide Regulation, Department of ",3,14058135,109485,13948650
9945,r056,"United States<sup>b</sup> -> California -> Public Health, Department of",United States<sup>b</sup>,California,"Public Health, Department of",3,6155476,46500,6108976
9945,r057,"United States<sup>b</sup> -> California -> Public Utilities Commission, Executive Division",United States<sup>b</sup>,California,"Public Utilities Commission, Executive Division",3,61374566,0,61374566
9945,r058,"United States<sup>b</sup> -> California -> Rehabilitation, Department of ",United States<sup>b</sup>,California,"Rehabilitation, Department of ",3,1619410,1619410,0
9945,r059,United States<sup>b</sup> -> California -> State Coastal Conservancy,United States<sup>b</sup>,California,State Coastal Conservancy,3,942260,173892,768368
9945,r060,United States<sup>b</sup> -> California -> State Water Resources Control Board,United States<sup>b</sup>,California,State Water Resources Control Board,3,8564983,806267,7758716
9945,r061,"United States<sup>b</sup> -> California -> Toxic Substances Control, Department of",United States<sup>b</sup>,California,"Toxic Substances Control, Department of",3,645987,0,645987
9945,r062,"United States<sup>b</sup> -> California -> Transportation, Department of",United States<sup>b</sup>,California,"Transportation, Department of",3,39260000,16060000,23200000
9945,r063,"United States<sup>b</sup> -> California -> Water Resources, Department of",United States<sup>b</sup>,California,"Water Resources, Department of",3,13051260,0,13051260
9945,r064,United States<sup>b</sup> -> Colorado,United States<sup>b</sup>,Colorado,,2,38058349,5096962,32961387
9945,r065,"United States<sup>b</sup> -> Colorado -> Agriculture, Department of",United States<sup>b</sup>,Colorado,"Agriculture, Department of",3,581906,576906,5000
9945,r066,"United States<sup>b</sup> -> Colorado -> Economic Development and International Trade, Office of",United States<sup>b</sup>,Colorado,"Economic Development and International Trade, Office of",3,20576916,0,20576916
9945,r067,"United States<sup>b</sup> -> Colorado -> Higher Education Competitive, Research Authority",United States<sup>b</sup>,Colorado,"Higher Education Competitive, Research Authority",3,1443141,0,1443141
9945,r068,"United States<sup>b</sup> -> Colorado -> Higher Education, Department of ",United States<sup>b</sup>,Colorado,"Higher Education, Department of ",3,2425000,0,2425000
9945,r069,"United States<sup>b</sup> -> Colorado -> Natural Resources, Department of",United States<sup>b</sup>,Colorado,"Natural Resources, Department of",3,5062623,998132,4064491
9945,r070,"United States<sup>b</sup> -> Colorado -> Public Health and Environment, Department of",United States<sup>b</sup>,Colorado,"Public Health and Environment, Department of",3,3363873,6494,3357379
9945,r071,"United States<sup>b</sup> -> Colorado -> Public Safety, Department of; Division of Criminal Justice",United States<sup>b</sup>,Colorado,"Public Safety, Department of; Division of Criminal Justice",3,985007,124589,860418
9945,r072,"United States<sup>b</sup> -> Colorado -> Transportation, Department of",United States<sup>b</sup>,Colorado,"Transportation, Department of",3,3390841,3390841,0
9945,r073,United States<sup>b</sup> -> Colorado -> Wine Industry Development Board,United States<sup>b</sup>,Colorado,Wine Industry Development Board,3,229042,0,229042
9945,r074,United States<sup>b</sup> -> Connecticut,United States<sup>b</sup>,Connecticut,,2,60578799,14622416,45956383
9945,r075,United States<sup>b</sup> -> Connecticut -> Agricultural Experiment Station,United States<sup>b</sup>,Connecticut,Agricultural Experiment Station,3,13756272,5475135,8281137
9945,r076,"United States<sup>b</sup> -> Connecticut -> Energy and Environmental Protection, Department of",United States<sup>b</sup>,Connecticut,"Energy and Environmental Protection, Department of",3,7320822,5622094,1698728
9945,r077,United States<sup>b</sup> -> Connecticut -> Innovation Inc.,United States<sup>b</sup>,Connecticut,Innovation Inc.,3,28919435,0,28919435
9945,r078,"United States<sup>b</sup> -> Connecticut -> Mental Health and Addiction Services, Department of",United States<sup>b</sup>,Connecticut,"Mental Health and Addiction Services, Department of",3,7217443,910960,6306483
9945,r079,"United States<sup>b</sup> -> Connecticut -> Public Health, Department of",United States<sup>b</sup>,Connecticut,"Public Health, Department of",3,1780,1780,0
9945,r080,"United States<sup>b</sup> -> Connecticut -> Social Services, Department of",United States<sup>b</sup>,Connecticut,"Social Services, Department of",3,391305,0,391305
9945,r081,"United States<sup>b</sup> -> Connecticut -> Transportation, Department of",United States<sup>b</sup>,Connecticut,"Transportation, Department of",3,2971742,2612447,359295
9945,r082,United States<sup>b</sup> -> Delaware,United States<sup>b</sup>,Delaware,,2,3446375,1533976,1912399
9945,r083,United States<sup>b</sup> -> Delaware -> Geological Survey,United States<sup>b</sup>,Delaware,Geological Survey,3,1618967,456801,1162166
9945,r084,"United States<sup>b</sup> -> Delaware -> Natural Resources and Environmental Control, Department of",United States<sup>b</sup>,Delaware,"Natural Resources and Environmental Control, Department of",3,646147,169828,476319
9945,r085,United States<sup>b</sup> -> Delaware -> Sustainable Energy Utility,United States<sup>b</sup>,Delaware,Sustainable Energy Utility,3,10495,0,10495
9945,r086,"United States<sup>b</sup> -> Delaware -> Transportation, Department of",United States<sup>b</sup>,Delaware,"Transportation, Department of",3,1170766,907347,263419
9945,r087,United States<sup>b</sup> -> District of Columbia,United States<sup>b</sup>,District of Columbia,,2,10560754,8368175,2192579
9945,r088,"United States<sup>b</sup> -> District of Columbia -> Energy and Environment, Department of",United States<sup>b</sup>,District of Columbia,"Energy and Environment, Department of",3,476600,30000,446600
9945,r089,"United States<sup>b</sup> -> District of Columbia -> Health, Department of",United States<sup>b</sup>,District of Columbia,"Health, Department of",3,8244141,8066164,177977
9945,r090,"United States<sup>b</sup> -> District of Columbia -> Transportation, Department of",United States<sup>b</sup>,District of Columbia,"Transportation, Department of",3,340013,272011,68002
9945,r091,United States<sup>b</sup> -> District of Columbia -> Water and Sewer Authority,United States<sup>b</sup>,District of Columbia,Water and Sewer Authority,3,1500000,0,1500000
9945,r092,United States<sup>b</sup> -> Florida,United States<sup>b</sup>,Florida,,2,180145644,27469288,152676356
9945,r093,"United States<sup>b</sup> -> Florida -> Agriculture and Consumer Services, Department of",United States<sup>b</sup>,Florida,"Agriculture and Consumer Services, Department of",3,18305424,5135974,13169450
9945,r094,"United States<sup>b</sup> -> Florida -> Citrus, Department of",United States<sup>b</sup>,Florida,"Citrus, Department of",3,850364,0,850364
9945,r095,"United States<sup>b</sup> -> Florida -> Environmental Protection, Department of",United States<sup>b</sup>,Florida,"Environmental Protection, Department of",3,68838,62212,6626
9945,r096,United States<sup>b</sup> -> Florida -> Fish and Wildlife Conservation Commission,United States<sup>b</sup>,Florida,Fish and Wildlife Conservation Commission,3,55428229,15951168,39477061
9945,r097,United States<sup>b</sup> -> Florida -> Gaming Control Commission,United States<sup>b</sup>,Florida,Gaming Control Commission,3,100000,0,100000
9945,r098,"United States<sup>b</sup> -> Florida -> Health, Department of",United States<sup>b</sup>,Florida,"Health, Department of",3,91360963,0,91360963
9945,r099,United States<sup>b</sup> -> Florida -> Space Florida,United States<sup>b</sup>,Florida,Space Florida,3,1305000,0,1305000
9945,r100,"United States<sup>b</sup> -> Florida -> Transportation, Department of",United States<sup>b</sup>,Florida,"Transportation, Department of",3,12726826,6319934,6406892
9945,r101,United States<sup>b</sup> -> Georgia,United States<sup>b</sup>,Georgia,,2,24988379,16555047,8433332
9945,r102,"United States<sup>b</sup> -> Georgia -> Natural Resources, Department of",United States<sup>b</sup>,Georgia,"Natural Resources, Department of",3,1452630,1205671,246959
9945,r103,United States<sup>b</sup> -> Georgia -> Southern States Energy Board,United States<sup>b</sup>,Georgia,Southern States Energy Board,3,19326825,11629167,7697658
9945,r104,"United States<sup>b</sup> -> Georgia -> Transportation, Department of",United States<sup>b</sup>,Georgia,"Transportation, Department of",3,4208924,3720209,488715
9945,r105,United States<sup>b</sup> -> Hawaii,United States<sup>b</sup>,Hawaii,,2,6337851,3397342,2940509
9945,r106,"United States<sup>b</sup> -> Hawaii -> Agriculture, Department of",United States<sup>b</sup>,Hawaii,"Agriculture, Department of",3,1098423,960221,138202
9945,r107,"United States<sup>b</sup> -> Hawaii -> Business, Economic Development, and Tourism, Department of",United States<sup>b</sup>,Hawaii,"Business, Economic Development, and Tourism, Department of",3,2022042,2042,2020000
9945,r108,"United States<sup>b</sup> -> Hawaii -> Land and Natural Resources, Department of",United States<sup>b</sup>,Hawaii,"Land and Natural Resources, Department of",3,424000,424000,0
9945,r109,United States<sup>b</sup> -> Hawaii -> Natural Energy Laboratory of Hawaii Authority,United States<sup>b</sup>,Hawaii,Natural Energy Laboratory of Hawaii Authority,3,0,0,0
9945,r110,"United States<sup>b</sup> -> Hawaii -> Transportation, Department of",United States<sup>b</sup>,Hawaii,"Transportation, Department of",3,2793386,2011079,782307
9945,r111,United States<sup>b</sup> -> Idaho,United States<sup>b</sup>,Idaho,,2,20444262,11009398,9434864
9945,r112,"United States<sup>b</sup> -> Idaho -> Agriculture, Department of",United States<sup>b</sup>,Idaho,"Agriculture, Department of",3,1623399,1623399,0
9945,r113,United States<sup>b</sup> -> Idaho -> Barley Commission,United States<sup>b</sup>,Idaho,Barley Commission,3,367497,0,367497
9945,r114,United States<sup>b</sup> -> Idaho -> Bean Commission,United States<sup>b</sup>,Idaho,Bean Commission,3,33833,0,33833
9945,r115,United States<sup>b</sup> -> Idaho -> Beef Council,United States<sup>b</sup>,Idaho,Beef Council,3,211642,0,211642
9945,r116,"United States<sup>b</sup> -> Idaho -> Commerce, Department of ",United States<sup>b</sup>,Idaho,"Commerce, Department of ",3,1289693,0,1289693
9945,r117,United States<sup>b</sup> -> Idaho -> Dairy West,United States<sup>b</sup>,Idaho,Dairy West,3,2999460,0,2999460
9945,r118,"United States<sup>b</sup> -> Idaho -> Fish and Game, Department of",United States<sup>b</sup>,Idaho,"Fish and Game, Department of",3,9041798,7234227,1807571
9945,r119,United States<sup>b</sup> -> Idaho -> Oilseed Commission,United States<sup>b</sup>,Idaho,Oilseed Commission,3,72645,0,72645
9945,r120,United States<sup>b</sup> -> Idaho -> Pea and Lentil Commission,United States<sup>b</sup>,Idaho,Pea and Lentil Commission,3,177697,0,177697
9945,r121,United States<sup>b</sup> -> Idaho -> Potato Commission,United States<sup>b</sup>,Idaho,Potato Commission,3,878871,0,878871
9945,r122,United States<sup>b</sup> -> Idaho -> Transportation Department,United States<sup>b</sup>,Idaho,Transportation Department,3,2467766,2151772,315994
9945,r123,United States<sup>b</sup> -> Idaho -> Wheat Commission,United States<sup>b</sup>,Idaho,Wheat Commission,3,1279961,0,1279961
9945,r124,United States<sup>b</sup> -> Illinois,United States<sup>b</sup>,Illinois,,2,16463839,7466369,8997470
9945,r125,"United States<sup>b</sup> -> Illinois -> Children and Family Services, Department of",United States<sup>b</sup>,Illinois,"Children and Family Services, Department of",3,2347655,0,2347655
9945,r126,"United States<sup>b</sup> -> Illinois -> Midwest Dairy Association, Illinois Division",United States<sup>b</sup>,Illinois,"Midwest Dairy Association, Illinois Division",3,20772,0,20772
9945,r127,United States<sup>b</sup> -> Illinois -> Nutrient Research and Education Council,United States<sup>b</sup>,Illinois,Nutrient Research and Education Council,3,3912499,0,3912499
9945,r128,"United States<sup>b</sup> -> Illinois -> Public Health, Department of",United States<sup>b</sup>,Illinois,"Public Health, Department of",3,400000,0,400000
9945,r129,"United States<sup>b</sup> -> Illinois -> Transportation, Department of",United States<sup>b</sup>,Illinois,"Transportation, Department of",3,9782913,7466369,2316544
9945,r130,United States<sup>b</sup> -> Indiana,United States<sup>b</sup>,Indiana,,2,12104856,7098396,5006460
9945,r131,United States<sup>b</sup> -> Indiana -> Economic Development Corporation,United States<sup>b</sup>,Indiana,Economic Development Corporation,3,3399111,0,3399111
9945,r132,"United States<sup>b</sup> -> Indiana -> Natural Resources, Department of",United States<sup>b</sup>,Indiana,"Natural Resources, Department of",3,852281,715281,137000
9945,r133,"United States<sup>b</sup> -> Indiana -> Transportation, Department of",United States<sup>b</sup>,Indiana,"Transportation, Department of",3,7853464,6383115,1470349
9945,r134,United States<sup>b</sup> -> Iowa,United States<sup>b</sup>,Iowa,,2,10636720,5359474,5277246
9945,r135,United States<sup>b</sup> -> Iowa -> Beef Industry Council,United States<sup>b</sup>,Iowa,Beef Industry Council,3,60218,0,60218
9945,r136,"United States<sup>b</sup> -> Iowa -> Human Rights, Criminal and Juvenile Justice Planning, Division of, Department of",United States<sup>b</sup>,Iowa,"Human Rights, Criminal and Juvenile Justice Planning, Division of, Department of",3,626038,247423,378615
9945,r137,"United States<sup>b</sup> -> Iowa -> Midwest Dairy Association, Iowa Division",United States<sup>b</sup>,Iowa,"Midwest Dairy Association, Iowa Division",3,119439,0,119439
9945,r138,"United States<sup>b</sup> -> Iowa -> Natural Resources, Department of",United States<sup>b</sup>,Iowa,"Natural Resources, Department of",3,3688099,2195710,1492389
9945,r139,"United States<sup>b</sup> -> Iowa -> Transportation, Department of",United States<sup>b</sup>,Iowa,"Transportation, Department of",3,6142926,2916341,3226585
9945,r140,United States<sup>b</sup> -> Kansas,United States<sup>b</sup>,Kansas,,2,17633236,9188967,8444269
9945,r141,United States<sup>b</sup> -> Kansas -> Corn Commission,United States<sup>b</sup>,Kansas,Corn Commission,3,311744,0,311744
9945,r142,United States<sup>b</sup> -> Kansas -> Grain Sorghum Commission,United States<sup>b</sup>,Kansas,Grain Sorghum Commission,3,700000,0,700000
9945,r143,"United States<sup>b</sup> -> Kansas -> Midwest Dairy Association, Kansas Division",United States<sup>b</sup>,Kansas,"Midwest Dairy Association, Kansas Division",3,15579,0,15579
9945,r144,United States<sup>b</sup> -> Kansas -> Soybean Commission,United States<sup>b</sup>,Kansas,Soybean Commission,3,1248862,0,1248862
9945,r145,United States<sup>b</sup> -> Kansas -> State Board of Regents,United States<sup>b</sup>,Kansas,State Board of Regents,3,997727,0,997727
9945,r146,United States<sup>b</sup> -> Kansas -> Sunflower Commission,United States<sup>b</sup>,Kansas,Sunflower Commission,3,20000,0,20000
9945,r147,"United States<sup>b</sup> -> Kansas -> Transportation, Department of",United States<sup>b</sup>,Kansas,"Transportation, Department of",3,3765115,2007023,1758092
9945,r148,United States<sup>b</sup> -> Kansas -> Water Office,United States<sup>b</sup>,Kansas,Water Office,3,1207240,156476,1050764
9945,r149,United States<sup>b</sup> -> Kansas -> Wheat Commission,United States<sup>b</sup>,Kansas,Wheat Commission,3,2245000,0,2245000
9945,r150,"United States<sup>b</sup> -> Kansas -> Wildlife and Parks, Department of",United States<sup>b</sup>,Kansas,"Wildlife and Parks, Department of",3,7121969,7025468,96501
9945,r151,United States<sup>b</sup> -> Kentucky,United States<sup>b</sup>,Kentucky,,2,34881537,10566579,24314958
9945,r152,"United States<sup>b</sup> -> Kentucky -> Economic Development, Cabinet for",United States<sup>b</sup>,Kentucky,"Economic Development, Cabinet for",3,3447809,0,3447809
9945,r153,"United States<sup>b</sup> -> Kentucky -> Fish and Wildlife Resources, Department of ",United States<sup>b</sup>,Kentucky,"Fish and Wildlife Resources, Department of ",3,6989041,4837624,2151417
9945,r154,United States<sup>b</sup> -> Kentucky -> Horse Racing Commission,United States<sup>b</sup>,Kentucky,Horse Racing Commission,3,70000,0,70000
9945,r155,"United States<sup>b</sup> -> Kentucky -> Nature Preserves, Office of Kentucky",United States<sup>b</sup>,Kentucky,"Nature Preserves, Office of Kentucky",3,42320,6330,35990
9945,r156,"United States<sup>b</sup> -> Kentucky -> Postsecondary Education, Council on",United States<sup>b</sup>,Kentucky,"Postsecondary Education, Council on",3,11572700,0,11572700
9945,r157,"United States<sup>b</sup> -> Kentucky -> Public Health, Department for ",United States<sup>b</sup>,Kentucky,"Public Health, Department for ",3,3767275,0,3767275
9945,r158,United States<sup>b</sup> -> Kentucky -> Soybean Promotion Board,United States<sup>b</sup>,Kentucky,Soybean Promotion Board,3,210727,0,210727
9945,r159,United States<sup>b</sup> -> Kentucky -> Transportation Cabinet,United States<sup>b</sup>,Kentucky,Transportation Cabinet,3,8781665,5722625,3059040
9945,r160,United States<sup>b</sup> -> Louisiana,United States<sup>b</sup>,Louisiana,,2,31843839,17690354,14153485
9945,r161,United States<sup>b</sup> -> Louisiana -> Board of Regents,United States<sup>b</sup>,Louisiana,Board of Regents,3,12613939,4874950,7738989
9945,r162,United States<sup>b</sup> -> Louisiana -> Coastal Protection and Restoration Authority,United States<sup>b</sup>,Louisiana,Coastal Protection and Restoration Authority,3,3681012,687877,2993135
9945,r163,"United States<sup>b</sup> -> Louisiana -> Transportation and Development, Department of ",United States<sup>b</sup>,Louisiana,"Transportation and Development, Department of ",3,10000000,8000000,2000000
9945,r164,"United States<sup>b</sup> -> Louisiana -> Wildlife and Fisheries, Department of",United States<sup>b</sup>,Louisiana,"Wildlife and Fisheries, Department of",3,5548888,4127527,1421361
9945,r165,United States<sup>b</sup> -> Maine,United States<sup>b</sup>,Maine,,2,24812470,13633417,11179053
9945,r166,"United States<sup>b</sup> -> Maine -> Agriculture, Conservation and Forestry, Department of ",United States<sup>b</sup>,Maine,"Agriculture, Conservation and Forestry, Department of ",3,1889382,896721,992661
9945,r167,United States<sup>b</sup> -> Maine -> Aquaculture Innovation Center,United States<sup>b</sup>,Maine,Aquaculture Innovation Center,3,555101,150000,405101
9945,r168,"United States<sup>b</sup> -> Maine -> Inland Fisheries and Wildlife, Department of",United States<sup>b</sup>,Maine,"Inland Fisheries and Wildlife, Department of",3,1080841,847899,232942
9945,r169,"United States<sup>b</sup> -> Maine -> Marine Resources, Department of",United States<sup>b</sup>,Maine,"Marine Resources, Department of",3,2712300,2165250,547050
9945,r170,"United States<sup>b</sup> -> Maine -> MDI Biological Laboratory, Center for Biomedical Innovation",United States<sup>b</sup>,Maine,"MDI Biological Laboratory, Center for Biomedical Innovation",3,9143683,8373547,770136
9945,r171,United States<sup>b</sup> -> Maine -> Technology Institute,United States<sup>b</sup>,Maine,Technology Institute,3,7931163,0,7931163
9945,r172,"United States<sup>b</sup> -> Maine -> Transportation, Department of ",United States<sup>b</sup>,Maine,"Transportation, Department of ",3,1500000,1200000,300000
9945,r173,United States<sup>b</sup> -> Maryland,United States<sup>b</sup>,Maryland,,2,31280581,1732396,29548185
9945,r174,United States<sup>b</sup> -> Maryland -> Energy Administration,United States<sup>b</sup>,Maryland,Energy Administration,3,2000000,0,2000000
9945,r175,"United States<sup>b</sup> -> Maryland -> Health, Department of",United States<sup>b</sup>,Maryland,"Health, Department of",3,15000000,0,15000000
9945,r176,"United States<sup>b</sup> -> Maryland -> Natural Resources, Department of",United States<sup>b</sup>,Maryland,"Natural Resources, Department of",3,410466,257993,152473
9945,r177,United States<sup>b</sup> -> Maryland -> Technology Development Corporation,United States<sup>b</sup>,Maryland,Technology Development Corporation,3,11227112,0,11227112
9945,r178,"United States<sup>b</sup> -> Maryland -> Transportation, Department of",United States<sup>b</sup>,Maryland,"Transportation, Department of",3,2643003,1474403,1168600
9945,r179,United States<sup>b</sup> -> Massachusetts,United States<sup>b</sup>,Massachusetts,,2,26616423,7056757,19559666
9945,r180,United States<sup>b</sup> -> Massachusetts -> Clean Energy Technology Center,United States<sup>b</sup>,Massachusetts,Clean Energy Technology Center,3,6848706,0,6848706
9945,r181,"United States<sup>b</sup> -> Massachusetts -> Environmental Protection, Department of ",United States<sup>b</sup>,Massachusetts,"Environmental Protection, Department of ",3,1771575,22369,1749206
9945,r182,"United States<sup>b</sup> -> Massachusetts -> Fish and Game, Department of ",United States<sup>b</sup>,Massachusetts,"Fish and Game, Department of ",3,1064180,769643,294537
9945,r183,United States<sup>b</sup> -> Massachusetts -> Gaming Commission,United States<sup>b</sup>,Massachusetts,Gaming Commission,3,2831240,0,2831240
9945,r184,United States<sup>b</sup> -> Massachusetts -> MassVentures,United States<sup>b</sup>,Massachusetts,MassVentures,3,3400000,0,3400000
9945,r185,"United States<sup>b</sup> -> Massachusetts -> Mental Health, Department of",United States<sup>b</sup>,Massachusetts,"Mental Health, Department of",3,2306184,115801,2190383
9945,r186,"United States<sup>b</sup> -> Massachusetts -> Public Health, Department of ",United States<sup>b</sup>,Massachusetts,"Public Health, Department of ",3,1888570,1503276,385294
9945,r187,United States<sup>b</sup> -> Massachusetts -> Technology Park Corporation ,United States<sup>b</sup>,Massachusetts,Technology Park Corporation ,3,1805968,1145668,660300
9945,r188,"United States<sup>b</sup> -> Massachusetts -> Transportation, Department of",United States<sup>b</sup>,Massachusetts,"Transportation, Department of",3,4050000,3500000,550000
9945,r189,United States<sup>b</sup> -> Massachusetts -> Water Resources Authority,United States<sup>b</sup>,Massachusetts,Water Resources Authority,3,650000,0,650000
9945,r190,United States<sup>b</sup> -> Michigan,United States<sup>b</sup>,Michigan,,2,30525914,6869738,23656176
9945,r191,"United States<sup>b</sup> -> Michigan -> Agriculture and Rural Development, Department of",United States<sup>b</sup>,Michigan,"Agriculture and Rural Development, Department of",3,3198958,523887,2675071
9945,r192,"United States<sup>b</sup> -> Michigan -> Environmental, Great Lakes, and Energy, Department of",United States<sup>b</sup>,Michigan,"Environmental, Great Lakes, and Energy, Department of",3,438854,228439,210415
9945,r193,United States<sup>b</sup> -> Michigan -> Health and Human Services,United States<sup>b</sup>,Michigan,Health and Human Services,3,662258,602087,60171
9945,r194,United States<sup>b</sup> -> Michigan -> Licensing and Regulatory Affairs,United States<sup>b</sup>,Michigan,Licensing and Regulatory Affairs,3,20000000,0,20000000
9945,r195,"United States<sup>b</sup> -> Michigan -> Transportation, Department of",United States<sup>b</sup>,Michigan,"Transportation, Department of",3,6225844,5515325,710519
9945,r196,United States<sup>b</sup> -> Minnesota,United States<sup>b</sup>,Minnesota,,2,25093959,8566979,16526980
9945,r197,"United States<sup>b</sup> -> Minnesota -> Agriculture, Department of",United States<sup>b</sup>,Minnesota,"Agriculture, Department of",3,5160630,810876,4349754
9945,r198,United States<sup>b</sup> -> Minnesota -> Forest Resources Council,United States<sup>b</sup>,Minnesota,Forest Resources Council,3,75000,0,75000
9945,r199,"United States<sup>b</sup> -> Minnesota -> Midwest Dairy Association, Minnesota Division",United States<sup>b</sup>,Minnesota,"Midwest Dairy Association, Minnesota Division",3,228492,0,228492
9945,r200,"United States<sup>b</sup> -> Minnesota -> Natural Resources, Department of",United States<sup>b</sup>,Minnesota,"Natural Resources, Department of",3,2220492,1384576,835916
9945,r201,United States<sup>b</sup> -> Minnesota -> Pollution Control Agency,United States<sup>b</sup>,Minnesota,Pollution Control Agency,3,233164,0,233164
9945,r202,"United States<sup>b</sup> -> Minnesota -> Transportation, Department of",United States<sup>b</sup>,Minnesota,"Transportation, Department of",3,17176181,6371527,10804654
9945,r203,United States<sup>b</sup> -> Mississippi,United States<sup>b</sup>,Mississippi,,2,9788541,7914852,1873689
9945,r204,"United States<sup>b</sup> -> Mississippi -> Agriculture and Commerce, Department of ",United States<sup>b</sup>,Mississippi,"Agriculture and Commerce, Department of ",3,114017,114017,0
9945,r205,"United States<sup>b</sup> -> Mississippi -> Environmental Quality, Department of",United States<sup>b</sup>,Mississippi,"Environmental Quality, Department of",3,833599,833599,0
9945,r206,United States<sup>b</sup> -> Mississippi -> Gulf States Marine Fisheries Commission,United States<sup>b</sup>,Mississippi,Gulf States Marine Fisheries Commission,3,927742,927742,0
9945,r207,"United States<sup>b</sup> -> Mississippi -> Marine Resources, Department of",United States<sup>b</sup>,Mississippi,"Marine Resources, Department of",3,2131369,1146778,984591
9945,r208,"United States<sup>b</sup> -> Mississippi -> Transportation, Department of",United States<sup>b</sup>,Mississippi,"Transportation, Department of",3,3300333,3021441,278892
9945,r209,"United States<sup>b</sup> -> Mississippi -> Wildlife, Fisheries, and Parks, Department of ",United States<sup>b</sup>,Mississippi,"Wildlife, Fisheries, and Parks, Department of ",3,2481481,1871275,610206
9945,r210,United States<sup>b</sup> -> Missouri,United States<sup>b</sup>,Missouri,,2,12430684,4836862,7593822
9945,r211,"United States<sup>b</sup> -> Missouri -> Agriculture, Department of",United States<sup>b</sup>,Missouri,"Agriculture, Department of",3,1197350,450447,746903
9945,r212,"United States<sup>b</sup> -> Missouri -> Conservation, Department of",United States<sup>b</sup>,Missouri,"Conservation, Department of",3,7039079,1726748,5312331
9945,r213,"United States<sup>b</sup> -> Missouri -> Mental Health, Department of",United States<sup>b</sup>,Missouri,"Mental Health, Department of",3,242500,0,242500
9945,r214,"United States<sup>b</sup> -> Missouri -> Natural Resources, Department of",United States<sup>b</sup>,Missouri,"Natural Resources, Department of",3,174359,22586,151773
9945,r215,United States<sup>b</sup> -> Missouri -> Technology Corporation,United States<sup>b</sup>,Missouri,Technology Corporation,3,500000,500000,0
9945,r216,"United States<sup>b</sup> -> Missouri -> Transportation, Department of",United States<sup>b</sup>,Missouri,"Transportation, Department of",3,2646956,2137081,509875
9945,r217,United States<sup>b</sup> -> Missouri -> Wine and Grape Board,United States<sup>b</sup>,Missouri,Wine and Grape Board,3,630440,0,630440
9945,r218,United States<sup>b</sup> -> Montana,United States<sup>b</sup>,Montana,,2,9752216,5647319,4104897
9945,r219,"United States<sup>b</sup> -> Montana -> Agriculture, Department of",United States<sup>b</sup>,Montana,"Agriculture, Department of",3,3359243,1412609,1946634
9945,r220,"United States<sup>b</sup> -> Montana -> Environmental Quality, Department of",United States<sup>b</sup>,Montana,"Environmental Quality, Department of",3,55000,10000,45000
9945,r221,"United States<sup>b</sup> -> Montana -> Fish, Wildlife and Parks, Department of",United States<sup>b</sup>,Montana,"Fish, Wildlife and Parks, Department of",3,3824321,3095894,728427
9945,r222,"United States<sup>b</sup> -> Montana -> Natural Resources and Conservation, Department of",United States<sup>b</sup>,Montana,"Natural Resources and Conservation, Department of",3,42740,42740,0
9945,r223,"United States<sup>b</sup> -> Montana -> Transportation, Department of",United States<sup>b</sup>,Montana,"Transportation, Department of",3,2470912,1086076,1384836
9945,r224,United States<sup>b</sup> -> Nebraska,United States<sup>b</sup>,Nebraska,,2,32687157,3981578,28705579
9945,r225,"United States<sup>b</sup> -> Nebraska -> Agriculture, Department of",United States<sup>b</sup>,Nebraska,"Agriculture, Department of",3,880683,662551,218132
9945,r226,United States<sup>b</sup> -> Nebraska -> Corn Board,United States<sup>b</sup>,Nebraska,Corn Board,3,798965,0,798965
9945,r227,United States<sup>b</sup> -> Nebraska -> Dry Bean Commission,United States<sup>b</sup>,Nebraska,Dry Bean Commission,3,305376,0,305376
9945,r228,"United States<sup>b</sup> -> Nebraska -> Economic Development, Department of",United States<sup>b</sup>,Nebraska,"Economic Development, Department of",3,6618124,0,6618124
9945,r229,United States<sup>b</sup> -> Nebraska -> Game and Parks Commission,United States<sup>b</sup>,Nebraska,Game and Parks Commission,3,3935042,2418852,1516190
9945,r230,United States<sup>b</sup> -> Nebraska -> Grain Sorghum Board,United States<sup>b</sup>,Nebraska,Grain Sorghum Board,3,5000,0,5000
9945,r231,"United States<sup>b</sup> -> Nebraska -> Health and Human Services, Department of",United States<sup>b</sup>,Nebraska,"Health and Human Services, Department of",3,18833700,0,18833700
9945,r232,"United States<sup>b</sup> -> Nebraska -> Midwest Dairy Association, Nebraska Division",United States<sup>b</sup>,Nebraska,"Midwest Dairy Association, Nebraska Division",3,31158,0,31158
9945,r233,"United States<sup>b</sup> -> Nebraska -> Natural Resources, Department of",United States<sup>b</sup>,Nebraska,"Natural Resources, Department of",3,50000,0,50000
9945,r234,United States<sup>b</sup> -> Nebraska -> Pea And Lentil Commission,United States<sup>b</sup>,Nebraska,Pea And Lentil Commission,3,1390,0,1390
9945,r235,"United States<sup>b</sup> -> Nebraska -> Transportation, Department of",United States<sup>b</sup>,Nebraska,"Transportation, Department of",3,1217719,900175,317544
9945,r236,United States<sup>b</sup> -> Nebraska -> Wheat Board,United States<sup>b</sup>,Nebraska,Wheat Board,3,10000,0,10000
9945,r237,United States<sup>b</sup> -> Nevada,United States<sup>b</sup>,Nevada,,2,3643395,2068342,1575053
9945,r238,"United States<sup>b</sup> -> Nevada -> Agriculture, Department of",United States<sup>b</sup>,Nevada,"Agriculture, Department of",3,208642,148642,60000
9945,r239,"United States<sup>b</sup> -> Nevada -> Economic Development, Governor's office of",United States<sup>b</sup>,Nevada,"Economic Development, Governor's office of",3,1327253,0,1327253
9945,r240,"United States<sup>b</sup> -> Nevada -> Transportation, Department of",United States<sup>b</sup>,Nevada,"Transportation, Department of",3,2107500,1919700,187800
9945,r241,United States<sup>b</sup> -> New Hampshire,United States<sup>b</sup>,New Hampshire,,2,9222505,756259,8466246
9945,r242,"United States<sup>b</sup> -> New Hampshire -> Agriculture, Markets and Food, Department of",United States<sup>b</sup>,New Hampshire,"Agriculture, Markets and Food, Department of",3,43897,21072,22825
9945,r243,"United States<sup>b</sup> -> New Hampshire -> Business and Economic Affairs, Department of",United States<sup>b</sup>,New Hampshire,"Business and Economic Affairs, Department of",3,7000000,0,7000000
9945,r244,"United States<sup>b</sup> -> New Hampshire -> Environmental Services, Department of",United States<sup>b</sup>,New Hampshire,"Environmental Services, Department of",3,1259624,0,1259624
9945,r245,"United States<sup>b</sup> -> New Hampshire -> Transportation, Department of",United States<sup>b</sup>,New Hampshire,"Transportation, Department of",3,918984,735187,183797
9945,r246,United States<sup>b</sup> -> New Jersey,United States<sup>b</sup>,New Jersey,,2,65020915,6943253,58077662
9945,r247,"United States<sup>b</sup> -> New Jersey -> Agriculture, Department of",United States<sup>b</sup>,New Jersey,"Agriculture, Department of",3,180151,180151,0
9945,r248,"United States<sup>b</sup> -> New Jersey -> Children and Families, Department of",United States<sup>b</sup>,New Jersey,"Children and Families, Department of",3,368019,29247,338772
9945,r249,"United States<sup>b</sup> -> New Jersey -> Community Affairs, Department of ",United States<sup>b</sup>,New Jersey,"Community Affairs, Department of ",3,22000,0,22000
9945,r250,"United States<sup>b</sup> -> New Jersey -> Corrections, Department of",United States<sup>b</sup>,New Jersey,"Corrections, Department of",3,416034,0,416034
9945,r251,"United States<sup>b</sup> -> New Jersey -> Environmental Protection, Department of",United States<sup>b</sup>,New Jersey,"Environmental Protection, Department of",3,6493270,478113,6015157
9945,r252,"United States<sup>b</sup> -> New Jersey -> Health, Department of",United States<sup>b</sup>,New Jersey,"Health, Department of",3,45343885,0,45343885
9945,r253,United States<sup>b</sup> -> New Jersey -> Pinelands Commission,United States<sup>b</sup>,New Jersey,Pinelands Commission,3,412081,412081,0
9945,r254,"United States<sup>b</sup> -> New Jersey -> Secretary of Higher Education, Office of",United States<sup>b</sup>,New Jersey,"Secretary of Higher Education, Office of",3,4500000,0,4500000
9945,r255,"United States<sup>b</sup> -> New Jersey -> State Parole Board, New Jersey",United States<sup>b</sup>,New Jersey,"State Parole Board, New Jersey",3,45969,45969,0
9945,r256,"United States<sup>b</sup> -> New Jersey -> Transit, New Jersey",United States<sup>b</sup>,New Jersey,"Transit, New Jersey",3,251362,0,251362
9945,r257,"United States<sup>b</sup> -> New Jersey -> Transportation, Department of",United States<sup>b</sup>,New Jersey,"Transportation, Department of",3,6988144,5797692,1190452
9945,r258,United States<sup>b</sup> -> New Mexico,United States<sup>b</sup>,New Mexico,,2,3456227,2479360,976867
9945,r259,"United States<sup>b</sup> -> New Mexico -> Cultural Affairs, Department of",United States<sup>b</sup>,New Mexico,"Cultural Affairs, Department of",3,105527,0,105527
9945,r260,"United States<sup>b</sup> -> New Mexico -> Game and Fish, Department of",United States<sup>b</sup>,New Mexico,"Game and Fish, Department of",3,1765554,1350750,414804
9945,r261,"United States<sup>b</sup> -> New Mexico -> Transportation, Department of",United States<sup>b</sup>,New Mexico,"Transportation, Department of",3,1400300,1120240,280060
9945,r262,United States<sup>b</sup> -> New Mexico -> Western State Air Resources Council,United States<sup>b</sup>,New Mexico,Western State Air Resources Council,3,184846,8370,176476
9945,r263,United States<sup>b</sup> -> New York,United States<sup>b</sup>,New York,,2,506283025,246154735,260128290
9945,r264,"United States<sup>b</sup> -> New York -> Agriculture and Markets, Department of ",United States<sup>b</sup>,New York,"Agriculture and Markets, Department of ",3,7728860,2935000,4793860
9945,r265,"United States<sup>b</sup> -> New York -> Economic Development, Department of",United States<sup>b</sup>,New York,"Economic Development, Department of",3,103874022,62729999,41144023
9945,r266,United States<sup>b</sup> -> New York -> Energy Research and Development Authority,United States<sup>b</sup>,New York,Energy Research and Development Authority,3,56620719,0,56620719
9945,r267,"United States<sup>b</sup> -> New York -> Environmental Conservation, Department of ",United States<sup>b</sup>,New York,"Environmental Conservation, Department of ",3,8217418,1388549,6828869
9945,r268,"United States<sup>b</sup> -> New York -> Health, Department of ",United States<sup>b</sup>,New York,"Health, Department of ",3,58241006,20543519,37697487
9945,r269,"United States<sup>b</sup> -> New York -> Mental Health, Office of ",United States<sup>b</sup>,New York,"Mental Health, Office of ",3,170676444,97095551,73580893
9945,r270,"United States<sup>b</sup> -> New York -> People with Developmental Disabilities, Office of",United States<sup>b</sup>,New York,"People with Developmental Disabilities, Office of",3,1682143,1471237,210906
9945,r271,United States<sup>b</sup> -> New York -> Power Authority,United States<sup>b</sup>,New York,Power Authority,3,9714648,300000,9414648
9945,r272,United States<sup>b</sup> -> New York -> Roswell Park Comprehensive Cancer Center,United States<sup>b</sup>,New York,Roswell Park Comprehensive Cancer Center,3,71562773,54056730,17506043
9945,r273,United States<sup>b</sup> -> New York -> State Museum,United States<sup>b</sup>,New York,State Museum,3,10982258,372196,10610062
9945,r274,United States<sup>b</sup> -> New York -> Thoroughbred Breeding and Development Fund Corp.,United States<sup>b</sup>,New York,Thoroughbred Breeding and Development Fund Corp.,3,405292,0,405292
9945,r275,"United States<sup>b</sup> -> New York -> Transportation, Department of ",United States<sup>b</sup>,New York,"Transportation, Department of ",3,6577442,5261954,1315488
9945,r276,United States<sup>b</sup> -> North Carolina,United States<sup>b</sup>,North Carolina,,2,38818576,9627170,29191406
9945,r277,"United States<sup>b</sup> -> North Carolina -> Agriculture and Consumer Services, Department of",United States<sup>b</sup>,North Carolina,"Agriculture and Consumer Services, Department of",3,15422911,0,15422911
9945,r278,United States<sup>b</sup> -> North Carolina -> Biotechnology Center,United States<sup>b</sup>,North Carolina,Biotechnology Center,3,2841679,0,2841679
9945,r279,"United States<sup>b</sup> -> North Carolina -> Environmental Quality, Department of",United States<sup>b</sup>,North Carolina,"Environmental Quality, Department of",3,3275157,1288170,1986987
9945,r280,"United States<sup>b</sup> -> North Carolina -> Natural and Cultural Resources, Department of",United States<sup>b</sup>,North Carolina,"Natural and Cultural Resources, Department of",3,2425310,0,2425310
9945,r281,"United States<sup>b</sup> -> North Carolina -> Science Technology & Innovation, Office of",United States<sup>b</sup>,North Carolina,"Science Technology & Innovation, Office of",3,4660090,0,4660090
9945,r282,"United States<sup>b</sup> -> North Carolina -> Transportation, Department of",United States<sup>b</sup>,North Carolina,"Transportation, Department of",3,10050000,8339000,1711000
9945,r283,United States<sup>b</sup> -> North Carolina -> Wine and Grape Growers Council,United States<sup>b</sup>,North Carolina,Wine and Grape Growers Council,3,143429,0,143429
9945,r284,United States<sup>b</sup> -> North Dakota,United States<sup>b</sup>,North Dakota,,2,17874336,1904626,15969710
9945,r285,"United States<sup>b</sup> -> North Dakota -> Agriculture, Department of",United States<sup>b</sup>,North Dakota,"Agriculture, Department of",3,3313396,0,3313396
9945,r286,United States<sup>b</sup> -> North Dakota -> Dry Pea and Lentil Commission,United States<sup>b</sup>,North Dakota,Dry Pea and Lentil Commission,3,282308,0,282308
9945,r287,"United States<sup>b</sup> -> North Dakota -> Game and Fish, Department of",United States<sup>b</sup>,North Dakota,"Game and Fish, Department of",3,595698,547270,48428
9945,r288,United States<sup>b</sup> -> North Dakota -> Historical Society of North Dakota,United States<sup>b</sup>,North Dakota,Historical Society of North Dakota,3,93115,93115,0
9945,r289,United States<sup>b</sup> -> North Dakota -> Industrial Commission,United States<sup>b</sup>,North Dakota,Industrial Commission,3,9398767,0,9398767
9945,r290,"United States<sup>b</sup> -> North Dakota -> Midwest Dairy Association, North Dakota Division",United States<sup>b</sup>,North Dakota,"Midwest Dairy Association, North Dakota Division",3,5193,0,5193
9945,r291,United States<sup>b</sup> -> North Dakota -> Soybean Council,United States<sup>b</sup>,North Dakota,Soybean Council,3,1622297,0,1622297
9945,r292,"United States<sup>b</sup> -> North Dakota -> Transportation, Department of",United States<sup>b</sup>,North Dakota,"Transportation, Department of",3,1298374,1264241,34133
9945,r293,United States<sup>b</sup> -> North Dakota -> Wheat Commission,United States<sup>b</sup>,North Dakota,Wheat Commission,3,1265188,0,1265188
9945,r294,United States<sup>b</sup> -> Ohio,United States<sup>b</sup>,Ohio,,2,70471571,8153111,62318460
9945,r295,"United States<sup>b</sup> -> Ohio -> Development, Department of",United States<sup>b</sup>,Ohio,"Development, Department of",3,57980338,0,57980338
9945,r296,"United States<sup>b</sup> -> Ohio -> Education, Department of",United States<sup>b</sup>,Ohio,"Education, Department of",3,180000,160000,20000
9945,r297,United States<sup>b</sup> -> Ohio -> Environmental Protection Agency,United States<sup>b</sup>,Ohio,Environmental Protection Agency,3,379412,361107,18305
9945,r298,"United States<sup>b</sup> -> Ohio -> Natural Resources, Department of",United States<sup>b</sup>,Ohio,"Natural Resources, Department of",3,3723242,2503983,1219259
9945,r299,"United States<sup>b</sup> -> Ohio -> Transportation, Department of",United States<sup>b</sup>,Ohio,"Transportation, Department of",3,6349868,5128021,1221847
9945,r300,United States<sup>b</sup> -> Ohio -> Water Development Authority,United States<sup>b</sup>,Ohio,Water Development Authority,3,1858711,0,1858711
9945,r301,United States<sup>b</sup> -> Oklahoma,United States<sup>b</sup>,Oklahoma,,2,27646238,7056971,20589267
9945,r302,"United States<sup>b</sup> -> Oklahoma -> Advancement of Science and Technology, Center for the ",United States<sup>b</sup>,Oklahoma,"Advancement of Science and Technology, Center for the ",3,8629841,0,8629841
9945,r303,"United States<sup>b</sup> -> Oklahoma -> Agriculture, Food, and Forestry, Department of",United States<sup>b</sup>,Oklahoma,"Agriculture, Food, and Forestry, Department of",3,443596,443596,0
9945,r304,"United States<sup>b</sup> -> Oklahoma -> Environmental Quality, Department of",United States<sup>b</sup>,Oklahoma,"Environmental Quality, Department of",3,345916,239362,106554
9945,r305,United States<sup>b</sup> -> Oklahoma -> Grand River Dam Authority,United States<sup>b</sup>,Oklahoma,Grand River Dam Authority,3,525000,0,525000
9945,r306,"United States<sup>b</sup> -> Oklahoma -> Health, Department of",United States<sup>b</sup>,Oklahoma,"Health, Department of",3,1053610,1053610,0
9945,r307,"United States<sup>b</sup> -> Oklahoma -> Human Services, Department of",United States<sup>b</sup>,Oklahoma,"Human Services, Department of",3,459801,390858,68943
9945,r308,"United States<sup>b</sup> -> Oklahoma -> Midwest Dairy Association, Oklahoma Division",United States<sup>b</sup>,Oklahoma,"Midwest Dairy Association, Oklahoma Division",3,5193,0,5193
9945,r309,United States<sup>b</sup> -> Oklahoma -> Tobacco Settlement Endowment Trust,United States<sup>b</sup>,Oklahoma,Tobacco Settlement Endowment Trust,3,10903905,0,10903905
9945,r310,"United States<sup>b</sup> -> Oklahoma -> Transportation, Department of",United States<sup>b</sup>,Oklahoma,"Transportation, Department of",3,3568372,3281609,286763
9945,r311,"United States<sup>b</sup> -> Oklahoma -> Wildlife Conservation, Department of",United States<sup>b</sup>,Oklahoma,"Wildlife Conservation, Department of",3,1711004,1647936,63068
9945,r312,United States<sup>b</sup> -> Oregon,United States<sup>b</sup>,Oregon,,2,33801166,13854858,19946308
9945,r313,"United States<sup>b</sup> -> Oregon -> Agriculture, Department of",United States<sup>b</sup>,Oregon,"Agriculture, Department of",3,248348,0,248348
9945,r314,United States<sup>b</sup> -> Oregon -> Business Oregon,United States<sup>b</sup>,Oregon,Business Oregon,3,11252148,0,11252148
9945,r315,"United States<sup>b</sup> -> Oregon -> Environmental Quality, Department of",United States<sup>b</sup>,Oregon,"Environmental Quality, Department of",3,145000,0,145000
9945,r316,"United States<sup>b</sup> -> Oregon -> Fish and Wildlife, Department of",United States<sup>b</sup>,Oregon,"Fish and Wildlife, Department of",3,14109145,9774300,4334845
9945,r317,"United States<sup>b</sup> -> Oregon -> Forestry, Department of",United States<sup>b</sup>,Oregon,"Forestry, Department of",3,700000,0,700000
9945,r318,"United States<sup>b</sup> -> Oregon -> Geology and Mineral Industries, Department of",United States<sup>b</sup>,Oregon,"Geology and Mineral Industries, Department of",3,942340,888824,53516
9945,r319,"United States<sup>b</sup> -> Oregon -> Human Services, Department of",United States<sup>b</sup>,Oregon,"Human Services, Department of",3,778318,315911,462407
9945,r320,"United States<sup>b</sup> -> Oregon -> Transportation, Department of",United States<sup>b</sup>,Oregon,"Transportation, Department of",3,4292580,2873418,1419162
9945,r321,United States<sup>b</sup> -> Oregon -> Water Resources Department,United States<sup>b</sup>,Oregon,Water Resources Department,3,1067424,0,1067424
9945,r322,United States<sup>b</sup> -> Oregon -> Watershed Enhancement Board,United States<sup>b</sup>,Oregon,Watershed Enhancement Board,3,265863,2405,263458
9945,r323,United States<sup>b</sup> -> Pennsylvania,United States<sup>b</sup>,Pennsylvania,,2,88557830,10203586,78354244
9945,r324,"United States<sup>b</sup> -> Pennsylvania -> Agriculture, Department of",United States<sup>b</sup>,Pennsylvania,"Agriculture, Department of",3,3206582,975731,2230851
9945,r325,"United States<sup>b</sup> -> Pennsylvania -> Community and Economic Development, Department of",United States<sup>b</sup>,Pennsylvania,"Community and Economic Development, Department of",3,22100000,0,22100000
9945,r326,"United States<sup>b</sup> -> Pennsylvania -> Conservation and Natural Resources, Department of",United States<sup>b</sup>,Pennsylvania,"Conservation and Natural Resources, Department of",3,505181,0,505181
9945,r327,"United States<sup>b</sup> -> Pennsylvania -> Environmental Protection, Department of",United States<sup>b</sup>,Pennsylvania,"Environmental Protection, Department of",3,196401,0,196401
9945,r328,United States<sup>b</sup> -> Pennsylvania -> Fish and Boat Commission,United States<sup>b</sup>,Pennsylvania,Fish and Boat Commission,3,348312,184998,163314
9945,r329,United States<sup>b</sup> -> Pennsylvania -> Game Commission,United States<sup>b</sup>,Pennsylvania,Game Commission,3,12697359,6072622,6624737
9945,r330,"United States<sup>b</sup> -> Pennsylvania -> Health, Department of",United States<sup>b</sup>,Pennsylvania,"Health, Department of",3,46483760,0,46483760
9945,r331,United States<sup>b</sup> -> Pennsylvania -> Susquehanna River Basin Commission,United States<sup>b</sup>,Pennsylvania,Susquehanna River Basin Commission,3,130000,80000,50000
9945,r332,"United States<sup>b</sup> -> Pennsylvania -> Transportation, Department of",United States<sup>b</sup>,Pennsylvania,"Transportation, Department of",3,2890235,2890235,0
9945,r333,United States<sup>b</sup> -> Rhode Island,United States<sup>b</sup>,Rhode Island,,2,8361413,5740186,2621227
9945,r334,United States<sup>b</sup> -> Rhode Island -> Commerce Corporation,United States<sup>b</sup>,Rhode Island,Commerce Corporation,3,986076,0,986076
9945,r335,"United States<sup>b</sup> -> Rhode Island -> Fish and Wildlife; Environmental Management, Department of",United States<sup>b</sup>,Rhode Island,"Fish and Wildlife; Environmental Management, Department of",3,4044625,3248635,795990
9945,r336,"United States<sup>b</sup> -> Rhode Island -> Marine Fisheries; Environmental Management, Department of",United States<sup>b</sup>,Rhode Island,"Marine Fisheries; Environmental Management, Department of",3,2169953,1663937,506016
9945,r337,"United States<sup>b</sup> -> Rhode Island -> Narragansett Bay National Estuarine Research Reserve; Environmental Management, Department of",United States<sup>b</sup>,Rhode Island,"Narragansett Bay National Estuarine Research Reserve; Environmental Management, Department of",3,181937,152614,29323
9945,r338,"United States<sup>b</sup> -> Rhode Island -> Transportation, Department of",United States<sup>b</sup>,Rhode Island,"Transportation, Department of",3,900000,675000,225000
9945,r339,United States<sup>b</sup> -> Rhode Island -> Water Resources Board,United States<sup>b</sup>,Rhode Island,Water Resources Board,3,78822,0,78822
9945,r340,United States<sup>b</sup> -> South Carolina,United States<sup>b</sup>,South Carolina,,2,50056315,29762759,20293556
9945,r341,"United States<sup>b</sup> -> South Carolina -> Agriculture, Department of",United States<sup>b</sup>,South Carolina,"Agriculture, Department of",3,1180047,234809,945238
9945,r342,"United States<sup>b</sup> -> South Carolina -> Disabilities and Special Needs, Department of",United States<sup>b</sup>,South Carolina,"Disabilities and Special Needs, Department of",3,11798260,4863960,6934300
9945,r343,"United States<sup>b</sup> -> South Carolina -> Health and Environmental Control, Department of",United States<sup>b</sup>,South Carolina,"Health and Environmental Control, Department of",3,1146936,1075144,71792
9945,r344,"United States<sup>b</sup> -> South Carolina -> Mental Health, Department of",United States<sup>b</sup>,South Carolina,"Mental Health, Department of",3,39467,37855,1612
9945,r345,"United States<sup>b</sup> -> South Carolina -> Natural Resources, Department of",United States<sup>b</sup>,South Carolina,"Natural Resources, Department of",3,26580926,18374254,8206672
9945,r346,United States<sup>b</sup> -> South Carolina -> Public Service Authority,United States<sup>b</sup>,South Carolina,Public Service Authority,3,512345,0,512345
9945,r347,United States<sup>b</sup> -> South Carolina -> Research Authority,United States<sup>b</sup>,South Carolina,Research Authority,3,3197270,836251,2361019
9945,r348,United States<sup>b</sup> -> South Carolina -> Sea Grant Consortium,United States<sup>b</sup>,South Carolina,Sea Grant Consortium,3,3144115,2388066,756049
9945,r349,"United States<sup>b</sup> -> South Carolina -> Transportation, Department of",United States<sup>b</sup>,South Carolina,"Transportation, Department of",3,2456949,1952420,504529
9945,r350,United States<sup>b</sup> -> South Dakota,United States<sup>b</sup>,South Dakota,,2,4595753,1338277,3257476
9945,r351,United States<sup>b</sup> -> South Dakota -> Corn Utilization Council,United States<sup>b</sup>,South Dakota,Corn Utilization Council,3,50000,0,50000
9945,r352,"United States<sup>b</sup> -> South Dakota -> Midwest Dairy Association, South Dakota Division",United States<sup>b</sup>,South Dakota,"Midwest Dairy Association, South Dakota Division",3,67509,0,67509
9945,r353,United States<sup>b</sup> -> South Dakota -> Nutrient Research and Education Council,United States<sup>b</sup>,South Dakota,Nutrient Research and Education Council,3,972936,0,972936
9945,r354,United States<sup>b</sup> -> South Dakota -> Oilseeds Council,United States<sup>b</sup>,South Dakota,Oilseeds Council,3,352798,0,352798
9945,r355,United States<sup>b</sup> -> South Dakota -> Pulse Crop Council,United States<sup>b</sup>,South Dakota,Pulse Crop Council,3,31390,0,31390
9945,r356,United States<sup>b</sup> -> South Dakota -> Soybean Research and Promotion Council,United States<sup>b</sup>,South Dakota,Soybean Research and Promotion Council,3,449642,0,449642
9945,r357,"United States<sup>b</sup> -> South Dakota -> Transportation, Department of",United States<sup>b</sup>,South Dakota,"Transportation, Department of",3,2109493,1338277,771216
9945,r358,United States<sup>b</sup> -> South Dakota -> Weed and Pest Control Commission,United States<sup>b</sup>,South Dakota,Weed and Pest Control Commission,3,47000,0,47000
9945,r359,United States<sup>b</sup> -> South Dakota -> Wheat Commission,United States<sup>b</sup>,South Dakota,Wheat Commission,3,514985,0,514985
9945,r360,United States<sup>b</sup> -> Tennessee,United States<sup>b</sup>,Tennessee,,2,38959330,16915160,22044170
9945,r361,"United States<sup>b</sup> -> Tennessee -> Education, Department of",United States<sup>b</sup>,Tennessee,"Education, Department of",3,26245253,12443404,13801849
9945,r362,"United States<sup>b</sup> -> Tennessee -> Environment and Conservation, Department of",United States<sup>b</sup>,Tennessee,"Environment and Conservation, Department of",3,314273,151913,162360
9945,r363,United States<sup>b</sup> -> Tennessee -> LaunchTN,United States<sup>b</sup>,Tennessee,LaunchTN,3,7000000,0,7000000
9945,r364,"United States<sup>b</sup> -> Tennessee -> Transportation, Department of",United States<sup>b</sup>,Tennessee,"Transportation, Department of",3,5399804,4319843,1079961
9945,r365,United States<sup>b</sup> -> Texas,United States<sup>b</sup>,Texas,,2,247609284,27162975,220446309
9945,r366,"United States<sup>b</sup> -> Texas -> Agriculture, Department of",United States<sup>b</sup>,Texas,"Agriculture, Department of",3,1353356,810017,543339
9945,r367,United States<sup>b</sup> -> Texas -> Alzheimer's Research and Care Consortium (TARCC),United States<sup>b</sup>,Texas,Alzheimer's Research and Care Consortium (TARCC),3,4384547,0,4384547
9945,r368,United States<sup>b</sup> -> Texas -> Cancer Prevention and Research Institute,United States<sup>b</sup>,Texas,Cancer Prevention and Research Institute,3,208262268,0,208262268
9945,r369,"United States<sup>b</sup> -> Texas -> Environmental Quality, Commission on",United States<sup>b</sup>,Texas,"Environmental Quality, Commission on",3,1490243,609126,881117
9945,r370,United States<sup>b</sup> -> Texas -> Parks and Wildlife Department,United States<sup>b</sup>,Texas,Parks and Wildlife Department,3,4445763,3251253,1194510
9945,r371,"United States<sup>b</sup> -> Texas -> State Health Services, Department of ",United States<sup>b</sup>,Texas,"State Health Services, Department of ",3,1965537,1718344,247193
9945,r372,"United States<sup>b</sup> -> Texas -> Transportation, Department of",United States<sup>b</sup>,Texas,"Transportation, Department of",3,24982335,20774235,4208100
9945,r373,United States<sup>b</sup> -> Texas -> Water Development Board,United States<sup>b</sup>,Texas,Water Development Board,3,725235,0,725235
9945,r374,United States<sup>b</sup> -> Utah,United States<sup>b</sup>,Utah,,2,8837531,1669847,7167684
9945,r375,"United States<sup>b</sup> -> Utah -> Agriculture And Food, Department Of",United States<sup>b</sup>,Utah,"Agriculture And Food, Department Of",3,305965,305965,0
9945,r376,"United States<sup>b</sup> -> Utah -> Environmental Quality, Department of",United States<sup>b</sup>,Utah,"Environmental Quality, Department of",3,618560,131217,487343
9945,r377,"United States<sup>b</sup> -> Utah -> Natural Resources, Department of",United States<sup>b</sup>,Utah,"Natural Resources, Department of",3,5228943,0,5228943
9945,r378,"United States<sup>b</sup> -> Utah -> Transportation, Department of ",United States<sup>b</sup>,Utah,"Transportation, Department of ",3,2684063,1232665,1451398
9945,r379,United States<sup>b</sup> -> Vermont,United States<sup>b</sup>,Vermont,,2,1460157,1295178,164979
9945,r380,"United States<sup>b</sup> -> Vermont -> Agriculture, Food, and Markets, Agency of",United States<sup>b</sup>,Vermont,"Agriculture, Food, and Markets, Agency of",3,63773,0,63773
9945,r381,"United States<sup>b</sup> -> Vermont -> Human Services, Agency of",United States<sup>b</sup>,Vermont,"Human Services, Agency of",3,553199,553199,0
9945,r382,"United States<sup>b</sup> -> Vermont -> Transportation, Agency of",United States<sup>b</sup>,Vermont,"Transportation, Agency of",3,843185,741979,101206
9945,r383,United States<sup>b</sup> -> Virginia,United States<sup>b</sup>,Virginia,,2,40253504,16230355,24023149
9945,r384,"United States<sup>b</sup> -> Virginia -> Agriculture and Consumer Services, Department of",United States<sup>b</sup>,Virginia,"Agriculture and Consumer Services, Department of",3,2949439,374319,2575120
9945,r385,"United States<sup>b</sup> -> Virginia -> Behavioral Health And Developmental Services, Department of",United States<sup>b</sup>,Virginia,"Behavioral Health And Developmental Services, Department of",3,1240,0,1240
9945,r386,United States<sup>b</sup> -> Virginia -> Commonwealth Health Research Board,United States<sup>b</sup>,Virginia,Commonwealth Health Research Board,3,1249650,0,1249650
9945,r387,"United States<sup>b</sup> -> Virginia -> Education, Department of",United States<sup>b</sup>,Virginia,"Education, Department of",3,1115000,750000,365000
9945,r388,"United States<sup>b</sup> -> Virginia -> Energy, Department of",United States<sup>b</sup>,Virginia,"Energy, Department of",3,1629726,717742,911984
9945,r389,"United States<sup>b</sup> -> Virginia -> Environmental Quality, Department of",United States<sup>b</sup>,Virginia,"Environmental Quality, Department of",3,347705,298739,48966
9945,r390,"United States<sup>b</sup> -> Virginia -> Forensic Science, Department of",United States<sup>b</sup>,Virginia,"Forensic Science, Department of",3,1016000,327000,689000
9945,r391,"United States<sup>b</sup> -> Virginia -> Forestry, Department of",United States<sup>b</sup>,Virginia,"Forestry, Department of",3,610930,458198,152732
9945,r392,United States<sup>b</sup> -> Virginia -> Foundation for Healthy Youth,United States<sup>b</sup>,Virginia,Foundation for Healthy Youth,3,808437,0,808437
9945,r393,United States<sup>b</sup> -> Virginia -> Innovation Partnership Corporation,United States<sup>b</sup>,Virginia,Innovation Partnership Corporation,3,10980762,3996085,6984677
9945,r394,United States<sup>b</sup> -> Virginia -> Institute for Advanced Learning and Research,United States<sup>b</sup>,Virginia,Institute for Advanced Learning and Research,3,73000,0,73000
9945,r395,United States<sup>b</sup> -> Virginia -> Marine Resources Commission,United States<sup>b</sup>,Virginia,Marine Resources Commission,3,1990284,1651875,338409
9945,r396,"United States<sup>b</sup> -> Virginia -> Natural History, Museum of",United States<sup>b</sup>,Virginia,"Natural History, Museum of",3,856356,421,855935
9945,r397,United States<sup>b</sup> -> Virginia -> Rail And Public Transportation,United States<sup>b</sup>,Virginia,Rail And Public Transportation,3,260000,0,260000
9945,r398,"United States<sup>b</sup> -> Virginia -> Social Services, Department of",United States<sup>b</sup>,Virginia,"Social Services, Department of",3,1000000,500000,500000
9945,r399,"United States<sup>b</sup> -> Virginia -> Transportation, Department of",United States<sup>b</sup>,Virginia,"Transportation, Department of",3,13652178,6298398,7353780
9945,r400,"United States<sup>b</sup> -> Virginia -> Wildlife Resources, Department of",United States<sup>b</sup>,Virginia,"Wildlife Resources, Department of",3,1712797,857578,855219
9945,r401,United States<sup>b</sup> -> Washington,United States<sup>b</sup>,Washington,,2,60886219,15068376,45817843
9945,r402,"United States<sup>b</sup> -> Washington -> Agriculture, Department of",United States<sup>b</sup>,Washington,"Agriculture, Department of",3,3415009,2503676,911333
9945,r403,United States<sup>b</sup> -> Washington -> Alfalfa Seed Commission,United States<sup>b</sup>,Washington,Alfalfa Seed Commission,3,20000,0,20000
9945,r404,United States<sup>b</sup> -> Washington -> Asparagus Commission,United States<sup>b</sup>,Washington,Asparagus Commission,3,40000,0,40000
9945,r405,United States<sup>b</sup> -> Washington -> Blueberry Commission,United States<sup>b</sup>,Washington,Blueberry Commission,3,217000,0,217000
9945,r406,"United States<sup>b</sup> -> Washington -> Commerce, Department of",United States<sup>b</sup>,Washington,"Commerce, Department of",3,14792431,0,14792431
9945,r407,United States<sup>b</sup> -> Washington -> Cranberry Commission,United States<sup>b</sup>,Washington,Cranberry Commission,3,15880,0,15880
9945,r408,United States<sup>b</sup> -> Washington -> Dairy Products Commission,United States<sup>b</sup>,Washington,Dairy Products Commission,3,80000,0,80000
9945,r409,"United States<sup>b</sup> -> Washington -> Ecology, Department of",United States<sup>b</sup>,Washington,"Ecology, Department of",3,1353380,171355,1182025
9945,r410,"United States<sup>b</sup> -> Washington -> Fish and Wildlife, Department of",United States<sup>b</sup>,Washington,"Fish and Wildlife, Department of",3,11727293,4833459,6893834
9945,r411,United States<sup>b</sup> -> Washington -> Fruit Commission,United States<sup>b</sup>,Washington,Fruit Commission,3,97789,0,97789
9945,r412,United States<sup>b</sup> -> Washington -> Grain Commission,United States<sup>b</sup>,Washington,Grain Commission,3,2046962,0,2046962
9945,r413,"United States<sup>b</sup> -> Washington -> Health, Department of",United States<sup>b</sup>,Washington,"Health, Department of",3,1265000,898000,367000
9945,r414,United States<sup>b</sup> -> Washington -> Hop Commission,United States<sup>b</sup>,Washington,Hop Commission,3,134868,0,134868
9945,r415,"United States<sup>b</sup> -> Washington -> Labor and Industries, Department of",United States<sup>b</sup>,Washington,"Labor and Industries, Department of",3,3221766,625945,2595821
9945,r416,United States<sup>b</sup> -> Washington -> Mint Commission,United States<sup>b</sup>,Washington,Mint Commission,3,32739,0,32739
9945,r417,"United States<sup>b</sup> -> Washington -> Natural Resources, Department of",United States<sup>b</sup>,Washington,"Natural Resources, Department of",3,7767429,281577,7485852
9945,r418,United States<sup>b</sup> -> Washington -> Oilseeds Commission,United States<sup>b</sup>,Washington,Oilseeds Commission,3,120538,0,120538
9945,r419,"United States<sup>b</sup> -> Washington -> Pesticide Registration, Commission on",United States<sup>b</sup>,Washington,"Pesticide Registration, Commission on",3,405000,0,405000
9945,r420,United States<sup>b</sup> -> Washington -> Potato Commission,United States<sup>b</sup>,Washington,Potato Commission,3,895660,0,895660
9945,r421,United States<sup>b</sup> -> Washington -> Puget Sound Partnership,United States<sup>b</sup>,Washington,Puget Sound Partnership,3,2512800,1103200,1409600
9945,r422,United States<sup>b</sup> -> Washington -> Pulse Crops Commission,United States<sup>b</sup>,Washington,Pulse Crops Commission,3,124303,0,124303
9945,r423,United States<sup>b</sup> -> Washington -> Red Raspberry Commission,United States<sup>b</sup>,Washington,Red Raspberry Commission,3,180470,0,180470
9945,r424,"United States<sup>b</sup> -> Washington -> Transportation, Department of",United States<sup>b</sup>,Washington,"Transportation, Department of",3,4527700,3744600,783100
9945,r425,United States<sup>b</sup> -> Washington -> Tree Fruit Research Commission,United States<sup>b</sup>,Washington,Tree Fruit Research Commission,3,5231737,906564,4325173
9945,r426,United States<sup>b</sup> -> Washington -> Turfgrass Seed Commission,United States<sup>b</sup>,Washington,Turfgrass Seed Commission,3,157209,0,157209
9945,r427,United States<sup>b</sup> -> Washington -> Wine Commission,United States<sup>b</sup>,Washington,Wine Commission,3,503256,0,503256
9945,r428,United States<sup>b</sup> -> West Virginia,United States<sup>b</sup>,West Virginia,,2,9180282,4275461,4904821
9945,r429,"United States<sup>b</sup> -> West Virginia -> Agriculture, Department of",United States<sup>b</sup>,West Virginia,"Agriculture, Department of",3,244126,244126,0
9945,r430,United States<sup>b</sup> -> West Virginia -> Geological and Economic Survey,United States<sup>b</sup>,West Virginia,Geological and Economic Survey,3,2053431,234180,1819251
9945,r431,United States<sup>b</sup> -> West Virginia -> Higher Education Policy Commission,United States<sup>b</sup>,West Virginia,Higher Education Policy Commission,3,2748699,681636,2067063
9945,r432,"United States<sup>b</sup> -> West Virginia -> Natural Resources, Department of",United States<sup>b</sup>,West Virginia,"Natural Resources, Department of",3,1874026,1405519,468507
9945,r433,"United States<sup>b</sup> -> West Virginia -> Transportation, Department of",United States<sup>b</sup>,West Virginia,"Transportation, Department of",3,2260000,1710000,550000
9945,r434,United States<sup>b</sup> -> Wisconsin,United States<sup>b</sup>,Wisconsin,,2,19060693,9117475,9943218
9945,r435,"United States<sup>b</sup> -> Wisconsin -> Agriculture, Trade and Consumer Protection, Department of",United States<sup>b</sup>,Wisconsin,"Agriculture, Trade and Consumer Protection, Department of",3,2539311,2091953,447358
9945,r436,United States<sup>b</sup> -> Wisconsin -> Economic Development Corporation,United States<sup>b</sup>,Wisconsin,Economic Development Corporation,3,5256575,0,5256575
9945,r437,"United States<sup>b</sup> -> Wisconsin -> Natural Resources, Department of",United States<sup>b</sup>,Wisconsin,"Natural Resources, Department of",3,7047780,3155274,3892506
9945,r438,"United States<sup>b</sup> -> Wisconsin -> Transportation, Department of",United States<sup>b</sup>,Wisconsin,"Transportation, Department of",3,4217027,3870248,346779
9945,r439,United States<sup>b</sup> -> Wyoming,United States<sup>b</sup>,Wyoming,,2,5657338,3516837,2140501
9945,r440,"United States<sup>b</sup> -> Wyoming -> Agriculture, Department of",United States<sup>b</sup>,Wyoming,"Agriculture, Department of",3,640504,228171,412333
9945,r441,United States<sup>b</sup> -> Wyoming -> Business Council,United States<sup>b</sup>,Wyoming,Business Council,3,1011555,711555,300000
9945,r442,United States<sup>b</sup> -> Wyoming -> Enhanced Oil Recovery Institute,United States<sup>b</sup>,Wyoming,Enhanced Oil Recovery Institute,3,1032669,644812,387857
9945,r443,United States<sup>b</sup> -> Wyoming -> Game and Fish Department,United States<sup>b</sup>,Wyoming,Game and Fish Department,3,1658878,1161165,497713
9945,r444,United States<sup>b</sup> -> Wyoming -> State Geological Survey,United States<sup>b</sup>,Wyoming,State Geological Survey,3,235372,158542,76830
9945,r445,"United States<sup>b</sup> -> Wyoming -> Transportation, Department of",United States<sup>b</sup>,Wyoming,"Transportation, Department of",3,768083,612592,155491
9945,r446,United States<sup>b</sup> -> Wyoming -> Water Development Office,United States<sup>b</sup>,Wyoming,Water Development Office,3,310277,0,310277
9945,r447,Puerto Rico<sup>c</sup>,Puerto Rico<sup>c</sup>,,,1,17058786,6129178,10929608
9945,r448,Puerto Rico<sup>c</sup> -> Comprehensive Cancer Center,Puerto Rico<sup>c</sup>,Comprehensive Cancer Center,,2,8273926,4811207,3462719
9945,r449,Puerto Rico<sup>c</sup> -> Economic Development & Commerce,Puerto Rico<sup>c</sup>,Economic Development & Commerce,,2,760000,0,760000
9945,r450,Puerto Rico<sup>c</sup> -> Innovation & Technology Services,Puerto Rico<sup>c</sup>,Innovation & Technology Services,,2,3555203,253600,3301603
9945,r451,Puerto Rico<sup>c</sup> -> Institute of Statistics,Puerto Rico<sup>c</sup>,Institute of Statistics,,2,1462042,248999,1213043
9945,r452,Puerto Rico<sup>c</sup> -> Mental Health and Anti-Addiction Services Administration,Puerto Rico<sup>c</sup>,Mental Health and Anti-Addiction Services Administration,,2,225000,225000,0
9945,r453,"Puerto Rico<sup>c</sup> -> Science, Technology and Research Trust",Puerto Rico<sup>c</sup>,"Science, Technology and Research Trust",,2,2782615,590372,2192243
