table_id,row_id,_b_institution_b_full_path,_b_institution_b_level_1,_b_institution_b_level_2,_b_institution_b_hierarchy_depth,field_all_doctoral_students_rank,field_all_doctoral_students_total,field_all_doctoral_students_science,field_all_doctoral_students_engineering,field_all_doctoral_students_health,field_full_time_doctoral_students_rank,field_full_time_doctoral_students_total,field_full_time_doctoral_students_science,field_full_time_doctoral_students_engineering,field_full_time_doctoral_students_health,field_part_time_doctoral_students_rank,field_part_time_doctoral_students_total,field_part_time_doctoral_students_science,field_part_time_doctoral_students_engineering,field_part_time_doctoral_students_health
6048,r001,All institutions<sup>a</sup>,All institutions<sup>a</sup>,,1,-,283335,196742,71279,15314,-,247656,175039,62061,10556,-,35679,21703,9218,4758
6048,r002,All institutions<sup>a</sup> -> U. Michigan,All institutions<sup>a</sup>,U. Michigan,2,1,4604,2697,1701,206,1,4555,2690,1669,196,164,49,7,32,10
6048,r003,"All institutions<sup>a</sup> -> U. Illinois, Urbana-Champaign",All institutions<sup>a</sup>,"U. Illinois, Urbana-Champaign",2,2,4335,2691,1555,89,2,4230,2629,1517,84,105,105,62,38,5
6048,r004,All institutions<sup>a</sup> -> Texas A&M U.,All institutions<sup>a</sup>,Texas A&M U.,2,3,4169,2386,1668,115,5,3708,2113,1496,99,14,461,273,172,16
6048,r005,"All institutions<sup>a</sup> -> U. California, Berkeley",All institutions<sup>a</sup>,"U. California, Berkeley",2,4,4151,3100,1027,24,3,4151,3100,1027,24,341,0,0,0,0
6048,r006,All institutions<sup>a</sup> -> Purdue U.,All institutions<sup>a</sup>,Purdue U.,2,5,4010,1806,2015,189,20,3134,1555,1403,176,4,876,251,612,13
6048,r007,All institutions<sup>a</sup> -> Stanford U.,All institutions<sup>a</sup>,Stanford U.,2,6,4001,2520,1425,56,4,3986,2512,1418,56,259,15,8,7,0
6048,r008,All institutions<sup>a</sup> -> U. Wisconsin-Madison,All institutions<sup>a</sup>,U. Wisconsin-Madison,2,7,3923,2844,799,280,7,3515,2518,760,237,15,408,326,39,43
6048,r009,All institutions<sup>a</sup> -> Pennsylvania State U.,All institutions<sup>a</sup>,Pennsylvania State U.,2,8,3669,2402,1159,108,8,3512,2300,1123,89,67,157,102,36,19
6048,r010,"All institutions<sup>a</sup> -> U. California, Los Angeles",All institutions<sup>a</sup>,"U. California, Los Angeles",2,9,3667,2586,905,176,6,3667,2586,905,176,341,0,0,0,0
6048,r011,"All institutions<sup>a</sup> -> U. Texas, Austin",All institutions<sup>a</sup>,"U. Texas, Austin",2,10,3646,2086,1393,167,13,3388,1977,1264,147,37,258,109,129,20
6048,r012,All institutions<sup>a</sup> -> U. Washington,All institutions<sup>a</sup>,U. Washington,2,11,3644,2508,785,351,11,3435,2399,724,312,48,209,109,61,39
6048,r013,All institutions<sup>a</sup> -> Massachusetts Institute of Technology,All institutions<sup>a</sup>,Massachusetts Institute of Technology,2,12,3516,1970,1546,0,9,3507,1968,1539,0,284,9,2,7,0
6048,r014,All institutions<sup>a</sup> -> Cornell U.,All institutions<sup>a</sup>,Cornell U.,2,13,3500,2676,824,0,10,3500,2676,824,0,341,0,0,0,0
6048,r015,All institutions<sup>a</sup> -> Ohio State U.,All institutions<sup>a</sup>,Ohio State U.,2,14,3489,2282,1016,191,12,3418,2259,982,177,139,71,23,34,14
6048,r016,"All institutions<sup>a</sup> -> U. Maryland, College Park",All institutions<sup>a</sup>,"U. Maryland, College Park",2,15,3474,2398,819,257,17,3210,2260,734,216,35,264,138,85,41
6048,r017,All institutions<sup>a</sup> -> U. Colorado,All institutions<sup>a</sup>,U. Colorado,2,16,3445,2349,953,143,21,3093,2162,818,113,23,352,187,135,30
6048,r018,All institutions<sup>a</sup> -> U. Minnesota,All institutions<sup>a</sup>,U. Minnesota,2,17,3431,2382,828,221,16,3271,2281,783,207,66,160,101,45,14
6048,r019,All institutions<sup>a</sup> -> Georgia Institute of Technology,All institutions<sup>a</sup>,Georgia Institute of Technology,2,18,3380,1194,2186,0,18,3158,1122,2036,0,46,222,72,150,0
6048,r020,All institutions<sup>a</sup> -> Harvard U.,All institutions<sup>a</sup>,Harvard U.,2,19,3332,2954,281,97,14,3330,2952,281,97,320,2,2,0,0
6048,r021,"All institutions<sup>a</sup> -> U. California, Davis",All institutions<sup>a</sup>,"U. California, Davis",2,20,3318,2669,608,41,15,3288,2652,596,40,205,30,17,12,1
6048,r022,"All institutions<sup>a</sup> -> U. California, San Diego",All institutions<sup>a</sup>,"U. California, San Diego",2,21,3194,2244,950,0,19,3138,2222,916,0,154,56,22,34,0
6048,r023,All institutions<sup>a</sup> -> Johns Hopkins U.,All institutions<sup>a</sup>,Johns Hopkins U.,2,22,3188,1970,798,420,23,2717,1756,791,170,12,471,214,7,250
6048,r024,All institutions<sup>a</sup> -> U. Florida,All institutions<sup>a</sup>,U. Florida,2,23,3078,2066,842,170,22,2851,1915,768,168,45,227,151,74,2
6048,r025,All institutions<sup>a</sup> -> Arizona State U.,All institutions<sup>a</sup>,Arizona State U.,2,24,2951,1935,963,53,34,2154,1373,750,31,5,797,562,213,22
6048,r026,All institutions<sup>a</sup> -> North Carolina State U.,All institutions<sup>a</sup>,North Carolina State U.,2,25,2795,1571,1224,0,24,2595,1480,1115,0,54,200,91,109,0
6048,r027,"All institutions<sup>a</sup> -> U. California, Irvine",All institutions<sup>a</sup>,"U. California, Irvine",2,26,2596,1866,631,99,25,2580,1852,629,99,257,16,14,2,0
6048,r028,All institutions<sup>a</sup> -> U. Southern California,All institutions<sup>a</sup>,U. Southern California,2,27,2554,1658,704,192,27,2531,1650,692,189,230,23,8,12,3
6048,r029,All institutions<sup>a</sup> -> Northwestern U.,All institutions<sup>a</sup>,Northwestern U.,2,28,2553,1629,856,68,26,2539,1619,852,68,261,14,10,4,0
6048,r030,All institutions<sup>a</sup> -> U. Pennsylvania,All institutions<sup>a</sup>,U. Pennsylvania,2,29,2501,1949,552,0,28,2463,1935,528,0,178,38,14,24,0
6048,r031,"All institutions<sup>a</sup> -> Rutgers, State U. New Jersey",All institutions<sup>a</sup>,"Rutgers, State U. New Jersey",2,30,2492,2074,357,61,40,1989,1646,305,38,10,503,428,52,23
6048,r032,All institutions<sup>a</sup> -> Columbia U. in the City of New York,All institutions<sup>a</sup>,Columbia U. in the City of New York,2,31,2482,1805,611,66,30,2426,1767,604,55,154,56,38,7,11
6048,r033,"All institutions<sup>a</sup> -> U. North Carolina, Chapel Hill",All institutions<sup>a</sup>,"U. North Carolina, Chapel Hill",2,32,2473,2122,98,253,29,2439,2096,97,246,188,34,26,1,7
6048,r034,All institutions<sup>a</sup> -> Michigan State U.,All institutions<sup>a</sup>,Michigan State U.,2,33,2444,1971,406,67,31,2373,1912,396,65,139,71,59,10,2
6048,r035,All institutions<sup>a</sup> -> Indiana U.,All institutions<sup>a</sup>,Indiana U.,2,34,2418,2119,153,146,38,2049,1881,76,92,21,369,238,77,54
6048,r036,All institutions<sup>a</sup> -> Virginia Polytechnic Institute and State U.,All institutions<sup>a</sup>,Virginia Polytechnic Institute and State U.,2,35,2375,1253,1122,0,35,2127,1120,1007,0,40,248,133,115,0
6048,r037,All institutions<sup>a</sup> -> U. Chicago,All institutions<sup>a</sup>,U. Chicago,2,36,2362,2159,203,0,32,2362,2159,203,0,341,0,0,0,0
6048,r038,All institutions<sup>a</sup> -> U. Pittsburgh,All institutions<sup>a</sup>,U. Pittsburgh,2,37,2271,1526,528,217,33,2182,1483,507,192,116,89,43,21,25
6048,r039,All institutions<sup>a</sup> -> Princeton U.,All institutions<sup>a</sup>,Princeton U.,2,38,2123,1433,690,0,36,2123,1433,690,0,341,0,0,0,0
6048,r040,All institutions<sup>a</sup> -> U. Arizona,All institutions<sup>a</sup>,U. Arizona,2,39,2122,1623,308,191,47,1714,1310,250,154,15,408,313,58,37
6048,r041,All institutions<sup>a</sup> -> Duke U.,All institutions<sup>a</sup>,Duke U.,2,40,2107,1478,580,49,37,2107,1478,580,49,341,0,0,0,0
6048,r042,All institutions<sup>a</sup> -> Boston U.,All institutions<sup>a</sup>,Boston U.,2,41,2096,1429,517,150,39,2040,1406,516,118,154,56,23,1,32
6048,r043,All institutions<sup>a</sup> -> New York U.,All institutions<sup>a</sup>,New York U.,2,42,2065,1686,281,98,41,1938,1604,262,72,82,127,82,19,26
6048,r044,"All institutions<sup>a</sup> -> U. Massachusetts, Amherst",All institutions<sup>a</sup>,"U. Massachusetts, Amherst",2,43,1966,1501,400,65,46,1719,1315,353,51,41,247,186,47,14
6048,r045,All institutions<sup>a</sup> -> U. Utah,All institutions<sup>a</sup>,U. Utah,2,44,1941,1203,555,183,54,1543,960,450,133,19,398,243,105,50
6048,r046,All institutions<sup>a</sup> -> Carnegie Mellon U.,All institutions<sup>a</sup>,Carnegie Mellon U.,2,45,1929,1029,900,0,42,1900,1016,884,0,208,29,13,16,0
6048,r047,All institutions<sup>a</sup> -> U. Connecticut,All institutions<sup>a</sup>,U. Connecticut,2,46,1910,1266,524,120,49,1705,1133,467,105,51,205,133,57,15
6048,r048,All institutions<sup>a</sup> -> Iowa State U.,All institutions<sup>a</sup>,Iowa State U.,2,47,1902,1272,612,18,63,1296,883,402,11,7,606,389,210,7
6048,r049,All institutions<sup>a</sup> -> Yale U.,All institutions<sup>a</sup>,Yale U.,2,48,1899,1683,113,103,43,1886,1672,112,102,268,13,11,1,1
6048,r050,"All institutions<sup>a</sup> -> U. Illinois, Chicago",All institutions<sup>a</sup>,"U. Illinois, Chicago",2,49,1888,1163,396,329,55,1484,935,358,191,18,404,228,38,138
6048,r051,All institutions<sup>a</sup> -> U. Georgia,All institutions<sup>a</sup>,U. Georgia,2,50,1836,1585,96,155,45,1731,1497,92,142,105,105,88,4,13
6048,r052,"All institutions<sup>a</sup> -> U. California, Riverside",All institutions<sup>a</sup>,"U. California, Riverside",2,51,1808,1420,388,0,44,1807,1419,388,0,333,1,1,0,0
6048,r053,"All institutions<sup>a</sup> -> U. Tennessee, Knoxville",All institutions<sup>a</sup>,"U. Tennessee, Knoxville",2,52,1800,1061,671,68,86,870,544,289,37,3,930,517,382,31
6048,r054,"All institutions<sup>a</sup> -> SUNY, Stony Brook U.",All institutions<sup>a</sup>,"SUNY, Stony Brook U.",2,53,1755,1427,301,27,50,1704,1407,279,18,160,51,20,22,9
6048,r055,All institutions<sup>a</sup> -> U. Virginia,All institutions<sup>a</sup>,U. Virginia,2,54,1735,1070,635,30,48,1708,1060,625,23,217,27,10,10,7
6048,r056,"All institutions<sup>a</sup> -> U. California, Santa Barbara",All institutions<sup>a</sup>,"U. California, Santa Barbara",2,55,1700,1345,355,0,51,1700,1345,355,0,341,0,0,0,0
6048,r057,"All institutions<sup>a</sup> -> Washington U., Saint Louis",All institutions<sup>a</sup>,"Washington U., Saint Louis",2,56,1660,1218,411,31,52,1653,1218,404,31,294,7,0,7,0
6048,r058,All institutions<sup>a</sup> -> U. Houston,All institutions<sup>a</sup>,U. Houston,2,57,1654,1027,526,101,59,1411,859,466,86,42,243,168,60,15
6048,r059,All institutions<sup>a</sup> -> Vanderbilt U.,All institutions<sup>a</sup>,Vanderbilt U.,2,58,1610,1204,355,51,53,1594,1197,349,48,257,16,7,6,3
6048,r060,"All institutions<sup>a</sup> -> SUNY, U. Buffalo",All institutions<sup>a</sup>,"SUNY, U. Buffalo",2,59,1580,1052,384,144,109,619,447,126,46,2,961,605,258,98
6048,r061,"All institutions<sup>a</sup> -> Colorado State U., Fort Collins",All institutions<sup>a</sup>,"Colorado State U., Fort Collins",2,60,1560,1111,422,27,123,536,434,86,16,1,1024,677,336,11
6048,r062,All institutions<sup>a</sup> -> Florida State U.,All institutions<sup>a</sup>,Florida State U.,2,61,1547,1353,180,14,57,1419,1249,156,14,80,128,104,24,0
6048,r063,"All institutions<sup>a</sup> -> U. South Florida, Tampa",All institutions<sup>a</sup>,"U. South Florida, Tampa",2,62,1528,885,417,226,71,1220,751,363,106,29,308,134,54,120
6048,r064,All institutions<sup>a</sup> -> U. Delaware,All institutions<sup>a</sup>,U. Delaware,2,63,1514,1000,503,11,56,1482,985,486,11,195,32,15,17,0
6048,r065,All institutions<sup>a</sup> -> U. Central Florida,All institutions<sup>a</sup>,U. Central Florida,2,64,1477,811,625,41,62,1307,735,549,23,59,170,76,76,18
6048,r066,All institutions<sup>a</sup> -> Texas Tech U.,All institutions<sup>a</sup>,Texas Tech U.,2,65,1466,985,429,52,72,1207,844,321,42,36,259,141,108,10
6048,r067,All institutions<sup>a</sup> -> Northeastern U.,All institutions<sup>a</sup>,Northeastern U.,2,66,1440,717,667,56,58,1414,712,649,53,221,26,5,18,3
6048,r068,All institutions<sup>a</sup> -> Louisiana State U.,All institutions<sup>a</sup>,Louisiana State U.,2,67,1435,1061,310,64,68,1273,948,265,60,62,162,113,45,4
6048,r069,All institutions<sup>a</sup> -> Oregon State U.,All institutions<sup>a</sup>,Oregon State U.,2,68,1412,911,382,119,65,1286,839,335,112,84,126,72,47,7
6048,r070,All institutions<sup>a</sup> -> U. Iowa,All institutions<sup>a</sup>,U. Iowa,2,69,1400,1045,195,160,74,1192,901,168,123,50,208,144,27,37
6048,r071,All institutions<sup>a</sup> -> George Mason U.,All institutions<sup>a</sup>,George Mason U.,2,70,1394,1203,172,19,84,911,768,134,9,11,483,435,38,10
6048,r072,All institutions<sup>a</sup> -> U. Notre Dame,All institutions<sup>a</sup>,U. Notre Dame,2,71,1387,841,546,0,60,1375,834,541,0,273,12,7,5,0
6048,r073,All institutions<sup>a</sup> -> U. Kentucky,All institutions<sup>a</sup>,U. Kentucky,2,72,1365,989,239,137,64,1290,956,225,109,134,75,33,14,28
6048,r074,All institutions<sup>a</sup> -> California Institute of Technology,All institutions<sup>a</sup>,California Institute of Technology,2,73,1322,790,532,0,61,1322,790,532,0,341,0,0,0,0
6048,r075,All institutions<sup>a</sup> -> Clemson U.,All institutions<sup>a</sup>,Clemson U.,2,74,1320,727,562,31,73,1200,650,525,25,89,120,77,37,6
6048,r076,All institutions<sup>a</sup> -> U. Kansas,All institutions<sup>a</sup>,U. Kansas,2,75,1315,1018,177,120,69,1241,969,169,103,137,74,49,8,17
6048,r077,All institutions<sup>a</sup> -> U. Rochester,All institutions<sup>a</sup>,U. Rochester,2,76,1288,1047,226,15,67,1274,1035,226,13,261,14,12,0,2
6048,r078,All institutions<sup>a</sup> -> Washington State U.,All institutions<sup>a</sup>,Washington State U.,2,77,1287,917,315,55,75,1163,843,279,41,86,124,74,36,14
6048,r079,All institutions<sup>a</sup> -> Brown U.,All institutions<sup>a</sup>,Brown U.,2,78,1282,1086,154,42,66,1279,1085,153,41,317,3,1,1,1
6048,r080,All institutions<sup>a</sup> -> U. Cincinnati,All institutions<sup>a</sup>,U. Cincinnati,2,79,1277,697,374,206,80,1019,607,269,143,37,258,90,105,63
6048,r081,All institutions<sup>a</sup> -> Emory U.,All institutions<sup>a</sup>,Emory U.,2,80,1250,1063,120,67,70,1224,1062,96,66,221,26,1,24,1
6048,r082,"All institutions<sup>a</sup> -> U. Texas, Dallas",All institutions<sup>a</sup>,"U. Texas, Dallas",2,81,1243,745,471,27,77,1123,674,423,26,89,120,71,48,1
6048,r083,All institutions<sup>a</sup> -> U. Nebraska-Lincoln,All institutions<sup>a</sup>,U. Nebraska-Lincoln,2,82,1222,946,276,0,78,1079,829,250,0,70,143,117,26,0
6048,r084,All institutions<sup>a</sup> -> U. New Mexico,All institutions<sup>a</sup>,U. New Mexico,2,83,1174,814,245,115,114,582,419,91,72,8,592,395,154,43
6048,r085,"All institutions<sup>a</sup> -> U. Missouri, Columbia",All institutions<sup>a</sup>,"U. Missouri, Columbia",2,84,1158,862,200,96,93,837,684,101,52,26,321,178,99,44
6048,r086,All institutions<sup>a</sup> -> Liberty U.,All institutions<sup>a</sup>,Liberty U.,2,85,1157,1143,14,0,91,858,844,14,0,30,299,299,0,0
6048,r087,All institutions<sup>a</sup> -> Auburn U.,All institutions<sup>a</sup>,Auburn U.,2,86,1156,562,594,0,98,748,330,418,0,15,408,232,176,0
6048,r088,All institutions<sup>a</sup> -> Rice U.,All institutions<sup>a</sup>,Rice U.,2,87,1147,586,561,0,76,1143,583,560,0,310,4,3,1,0
6048,r089,All institutions<sup>a</sup> -> U. South Carolina,All institutions<sup>a</sup>,U. South Carolina,2,88,1101,689,249,163,81,980,629,220,131,87,121,60,29,32
6048,r090,All institutions<sup>a</sup> -> Florida International U.,All institutions<sup>a</sup>,Florida International U.,2,89,1081,750,253,78,79,1025,714,241,70,154,56,36,12,8
6048,r091,All institutions<sup>a</sup> -> George Washington U.,All institutions<sup>a</sup>,George Washington U.,2,90,1078,698,244,136,128,506,364,95,47,9,572,334,149,89
6048,r092,All institutions<sup>a</sup> -> U. Oklahoma,All institutions<sup>a</sup>,U. Oklahoma,2,91,1068,761,229,78,83,915,664,190,61,68,153,97,39,17
6048,r093,"All institutions<sup>a</sup> -> SUNY, Binghamton U.",All institutions<sup>a</sup>,"SUNY, Binghamton U.",2,92,1032,693,309,30,101,745,495,238,12,33,287,198,71,18
6048,r094,All institutions<sup>a</sup> -> Wayne State U.,All institutions<sup>a</sup>,Wayne State U.,2,93,1025,716,202,107,82,921,665,176,80,107,104,51,26,27
6048,r095,All institutions<sup>a</sup> -> Georgia State U.,All institutions<sup>a</sup>,Georgia State U.,2,94,999,860,0,139,85,879,792,0,87,89,120,68,0,52
6048,r096,All institutions<sup>a</sup> -> West Virginia U.,All institutions<sup>a</sup>,West Virginia U.,2,94,999,664,211,124,87,868,586,180,102,76,131,78,31,22
6048,r097,All institutions<sup>a</sup> -> Virginia Commonwealth U.,All institutions<sup>a</sup>,Virginia Commonwealth U.,2,96,941,480,207,254,96,807,428,186,193,74,134,52,21,61
6048,r098,"All institutions<sup>a</sup> -> U. Texas, Arlington",All institutions<sup>a</sup>,"U. Texas, Arlington",2,97,932,479,400,53,114,582,278,284,20,24,350,201,116,33
6048,r099,"All institutions<sup>a</sup> -> SUNY, U. Albany",All institutions<sup>a</sup>,"SUNY, U. Albany",2,98,921,860,23,38,135,453,418,21,14,13,468,442,2,24
6048,r100,All institutions<sup>a</sup> -> Syracuse U.,All institutions<sup>a</sup>,Syracuse U.,2,99,901,713,185,3,94,835,667,165,3,143,66,46,20,0
6048,r101,All institutions<sup>a</sup> -> Temple U.,All institutions<sup>a</sup>,Temple U.,2,100,900,759,102,39,88,864,729,96,39,183,36,30,6,0
6048,r102,"All institutions<sup>a</sup> -> U. North Texas, Denton",All institutions<sup>a</sup>,"U. North Texas, Denton",2,101,893,775,118,0,124,533,464,69,0,22,360,311,49,0
6048,r103,All institutions<sup>a</sup> -> Case Western Reserve U.,All institutions<sup>a</sup>,Case Western Reserve U.,2,102,884,496,354,34,92,850,479,338,33,188,34,17,16,1
6048,r104,All institutions<sup>a</sup> -> Mississippi State U.,All institutions<sup>a</sup>,Mississippi State U.,2,103,879,522,339,18,118,569,386,171,12,28,310,136,168,6
6048,r105,All institutions<sup>a</sup> -> U. Miami,All institutions<sup>a</sup>,U. Miami,2,104,876,707,124,45,90,862,695,123,44,261,14,12,1,1
6048,r106,"All institutions<sup>a</sup> -> U. California, San Francisco",All institutions<sup>a</sup>,"U. California, San Francisco",2,105,864,703,86,75,88,864,703,86,75,341,0,0,0,0
6048,r107,"All institutions<sup>a</sup> -> U. Texas Health Science Center, Houston",All institutions<sup>a</sup>,"U. Texas Health Science Center, Houston",2,106,856,682,38,136,112,590,493,36,61,34,266,189,2,75
6048,r108,All institutions<sup>a</sup> -> U. Oregon,All institutions<sup>a</sup>,U. Oregon,2,107,850,843,0,7,95,822,817,0,5,213,28,26,0,2
6048,r109,"All institutions<sup>a</sup> -> U. Alabama, Tuscaloosa",All institutions<sup>a</sup>,"U. Alabama, Tuscaloosa",2,108,844,540,274,30,98,748,495,234,19,111,96,45,40,11
6048,r110,"All institutions<sup>a</sup> -> U. Arkansas, Fayetteville",All institutions<sup>a</sup>,"U. Arkansas, Fayetteville",2,108,844,521,301,22,188,225,139,68,18,6,619,382,233,4
6048,r111,"All institutions<sup>a</sup> -> U. Alabama, Birmingham",All institutions<sup>a</sup>,"U. Alabama, Birmingham",2,110,842,682,99,61,104,712,614,64,34,78,130,68,35,27
6048,r112,"All institutions<sup>a</sup> -> U. Hawaii, Manoa",All institutions<sup>a</sup>,"U. Hawaii, Manoa",2,111,841,719,95,27,97,756,649,89,18,120,85,70,6,9
6048,r113,All institutions<sup>a</sup> -> Oklahoma State U.,All institutions<sup>a</sup>,Oklahoma State U.,2,112,806,626,180,0,110,597,455,142,0,48,209,171,38,0
6048,r114,All institutions<sup>a</sup> -> Kansas State U.,All institutions<sup>a</sup>,Kansas State U.,2,113,800,656,143,1,105,700,570,129,1,109,100,86,14,0
6048,r115,All institutions<sup>a</sup> -> U. Wisconsin-Milwaukee,All institutions<sup>a</sup>,U. Wisconsin-Milwaukee,2,114,790,482,155,153,102,729,467,139,123,147,61,15,16,30
6048,r116,All institutions<sup>a</sup> -> Tulane U.,All institutions<sup>a</sup>,Tulane U.,2,115,768,627,77,64,98,748,612,77,59,243,20,15,0,5
6048,r117,"All institutions<sup>a</sup> -> U. Nevada, Reno",All institutions<sup>a</sup>,"U. Nevada, Reno",2,116,763,541,205,17,106,697,496,184,17,143,66,45,21,0
6048,r118,All institutions<sup>a</sup> -> Drexel U.,All institutions<sup>a</sup>,Drexel U.,2,117,752,424,295,33,107,671,379,267,25,124,81,45,28,8
6048,r119,All institutions<sup>a</sup> -> Tufts U.,All institutions<sup>a</sup>,Tufts U.,2,118,731,532,159,40,103,714,521,153,40,254,17,11,6,0
6048,r120,All institutions<sup>a</sup> -> Claremont Graduate U.,All institutions<sup>a</sup>,Claremont Graduate U.,2,119,721,637,0,84,127,516,456,0,60,51,205,181,0,24
6048,r121,"All institutions<sup>a</sup> -> U. Nevada, Las Vegas",All institutions<sup>a</sup>,"U. Nevada, Las Vegas",2,120,709,551,93,65,126,519,423,71,25,56,190,128,22,40
6048,r122,"All institutions<sup>a</sup> -> U. Maryland, Baltimore County",All institutions<sup>a</sup>,"U. Maryland, Baltimore County",2,121,685,553,132,0,119,559,446,113,0,84,126,107,19,0
6048,r123,All institutions<sup>a</sup> -> U. Louisville,All institutions<sup>a</sup>,U. Louisville,2,122,665,399,161,105,113,583,355,149,79,123,82,44,12,26
6048,r124,All institutions<sup>a</sup> -> Dartmouth C.,All institutions<sup>a</sup>,Dartmouth C.,2,123,661,531,124,6,108,661,531,124,6,341,0,0,0,0
6048,r125,All institutions<sup>a</sup> -> Lehigh U.,All institutions<sup>a</sup>,Lehigh U.,2,124,647,306,341,0,110,597,280,317,0,162,50,26,24,0
6048,r126,"All institutions<sup>a</sup> -> U. North Carolina, Charlotte",All institutions<sup>a</sup>,"U. North Carolina, Charlotte",2,125,633,420,174,39,132,471,315,134,22,62,162,105,40,17
6048,r127,"All institutions<sup>a</sup> -> U. Texas, San Antonio",All institutions<sup>a</sup>,"U. Texas, San Antonio",2,126,632,390,235,7,148,383,251,131,1,39,249,139,104,6
6048,r128,All institutions<sup>a</sup> -> Colorado School of Mines,All institutions<sup>a</sup>,Colorado School of Mines,2,127,607,178,429,0,120,556,165,391,0,160,51,13,38,0
6048,r129,"All institutions<sup>a</sup> -> U. Massachusetts, Boston",All institutions<sup>a</sup>,"U. Massachusetts, Boston",2,128,597,499,0,98,143,401,359,0,42,55,196,140,0,56
6048,r130,All institutions<sup>a</sup> -> Georgetown U.,All institutions<sup>a</sup>,Georgetown U.,2,129,593,589,0,4,116,579,575,0,4,261,14,14,0,0
6048,r131,All institutions<sup>a</sup> -> Fielding Graduate U.,All institutions<sup>a</sup>,Fielding Graduate U.,2,130,592,592,0,0,128,506,506,0,0,117,86,86,0,0
6048,r132,All institutions<sup>a</sup> -> Old Dominion U.,All institutions<sup>a</sup>,Old Dominion U.,2,130,592,340,218,34,181,256,175,64,17,25,336,165,154,17
6048,r133,All institutions<sup>a</sup> -> Kent State U.,All institutions<sup>a</sup>,Kent State U.,2,132,590,520,0,70,120,556,498,0,58,188,34,22,0,12
6048,r134,"All institutions<sup>a</sup> -> U. California, Merced",All institutions<sup>a</sup>,"U. California, Merced",2,133,580,410,141,29,117,578,408,141,29,320,2,2,0,0
6048,r135,All institutions<sup>a</sup> -> Missouri U. of Science and Technology,All institutions<sup>a</sup>,Missouri U. of Science and Technology,2,134,576,157,419,0,138,433,131,302,0,70,143,26,117,0
6048,r136,All institutions<sup>a</sup> -> Baylor U.,All institutions<sup>a</sup>,Baylor U.,2,135,559,484,60,15,125,522,454,55,13,181,37,30,5,2
6048,r137,All institutions<sup>a</sup> -> Baylor C. of Medicine,All institutions<sup>a</sup>,Baylor C. of Medicine,2,136,552,550,0,2,122,552,550,0,2,341,0,0,0,0
6048,r138,"All institutions<sup>a</sup> -> U. Massachusetts, Lowell",All institutions<sup>a</sup>,"U. Massachusetts, Lowell",2,137,534,233,256,45,153,366,175,176,15,61,168,58,80,30
6048,r139,"All institutions<sup>a</sup> -> U. Texas, El Paso",All institutions<sup>a</sup>,"U. Texas, El Paso",2,138,507,284,194,29,165,322,195,115,12,57,185,89,79,17
6048,r140,All institutions<sup>a</sup> -> U. Memphis,All institutions<sup>a</sup>,U. Memphis,2,139,497,366,106,25,167,296,227,52,17,53,201,139,54,8
6048,r141,All institutions<sup>a</sup> -> North Dakota State U.,All institutions<sup>a</sup>,North Dakota State U.,2,140,494,342,130,22,174,284,207,63,14,47,210,135,67,8
6048,r142,All institutions<sup>a</sup> -> U. Mississippi,All institutions<sup>a</sup>,U. Mississippi,2,141,492,319,41,132,133,463,302,37,124,208,29,17,4,8
6048,r143,All institutions<sup>a</sup> -> U. Texas Southwestern Medical Center,All institutions<sup>a</sup>,U. Texas Southwestern Medical Center,2,142,491,440,51,0,130,489,438,51,0,320,2,2,0,0
6048,r144,All institutions<sup>a</sup> -> Boston C.,All institutions<sup>a</sup>,Boston C.,2,143,485,464,0,21,131,479,461,0,18,296,6,3,0,3
6048,r145,All institutions<sup>a</sup> -> New Jersey Institute of Technology,All institutions<sup>a</sup>,New Jersey Institute of Technology,2,144,478,245,233,0,142,403,211,192,0,134,75,34,41,0
6048,r146,All institutions<sup>a</sup> -> Howard U.,All institutions<sup>a</sup>,Howard U.,2,144,478,410,34,34,160,335,281,29,25,70,143,129,5,9
6048,r147,All institutions<sup>a</sup> -> U. Toledo,All institutions<sup>a</sup>,U. Toledo,2,146,474,310,102,62,156,346,231,67,48,80,128,79,35,14
6048,r148,All institutions<sup>a</sup> -> U. Wyoming,All institutions<sup>a</sup>,U. Wyoming,2,147,472,352,120,0,150,377,289,88,0,112,95,63,32,0
6048,r149,All institutions<sup>a</sup> -> Utah State U.,All institutions<sup>a</sup>,Utah State U.,2,148,471,366,105,0,211,155,122,33,0,27,316,244,72,0
6048,r150,All institutions<sup>a</sup> -> U. New Hampshire,All institutions<sup>a</sup>,U. New Hampshire,2,149,469,377,92,0,136,452,365,87,0,254,17,12,5,0
6048,r151,All institutions<sup>a</sup> -> Michigan Technological U.,All institutions<sup>a</sup>,Michigan Technological U.,2,149,469,229,240,0,151,376,193,183,0,113,93,36,57,0
6048,r152,All institutions<sup>a</sup> -> Texas Woman's U.,All institutions<sup>a</sup>,Texas Woman's U.,2,149,469,238,0,231,258,78,59,0,19,20,391,179,0,212
6048,r153,All institutions<sup>a</sup> -> Brandeis U.,All institutions<sup>a</sup>,Brandeis U.,2,152,465,465,0,0,134,459,459,0,0,296,6,6,0,0
6048,r154,All institutions<sup>a</sup> -> Western Michigan U.,All institutions<sup>a</sup>,Western Michigan U.,2,153,463,307,117,39,141,417,291,107,19,169,46,16,10,20
6048,r155,All institutions<sup>a</sup> -> New Mexico State U.,All institutions<sup>a</sup>,New Mexico State U.,2,153,463,317,131,15,147,385,274,104,7,127,78,43,27,8
6048,r156,All institutions<sup>a</sup> -> Florida Atlantic U.,All institutions<sup>a</sup>,Florida Atlantic U.,2,155,461,321,96,44,189,218,163,45,10,42,243,158,51,34
6048,r157,"All institutions<sup>a</sup> -> Southern Illinois U., Carbondale",All institutions<sup>a</sup>,"Southern Illinois U., Carbondale",2,156,459,360,99,0,162,332,276,56,0,82,127,84,43,0
6048,r158,All institutions<sup>a</sup> -> Portland State U.,All institutions<sup>a</sup>,Portland State U.,2,157,452,365,77,10,169,291,252,38,1,64,161,113,39,9
6048,r159,All institutions<sup>a</sup> -> U. Akron,All institutions<sup>a</sup>,U. Akron,2,158,447,253,190,4,154,362,202,158,2,120,85,51,32,2
6048,r160,All institutions<sup>a</sup> -> Saint Louis U.,All institutions<sup>a</sup>,Saint Louis U.,2,159,446,291,36,119,140,423,276,32,115,230,23,15,4,4
6048,r161,All institutions<sup>a</sup> -> U. Vermont,All institutions<sup>a</sup>,U. Vermont,2,159,446,385,43,18,145,396,352,36,8,162,50,33,7,10
6048,r162,All institutions<sup>a</sup> -> Worcester Polytechnic Institute,All institutions<sup>a</sup>,Worcester Polytechnic Institute,2,161,442,199,243,0,166,313,138,175,0,79,129,61,68,0
6048,r163,All institutions<sup>a</sup> -> Palo Alto U.,All institutions<sup>a</sup>,Palo Alto U.,2,162,441,441,0,0,137,436,436,0,0,303,5,5,0,0
6048,r164,All institutions<sup>a</sup> -> Montana State U.,All institutions<sup>a</sup>,Montana State U.,2,163,436,354,82,0,146,387,315,72,0,164,49,39,10,0
6048,r165,All institutions<sup>a</sup> -> U. Rhode Island,All institutions<sup>a</sup>,U. Rhode Island,2,164,431,278,94,59,155,354,238,76,40,128,77,40,18,19
6048,r166,All institutions<sup>a</sup> -> San Diego State U.,All institutions<sup>a</sup>,San Diego State U.,2,165,429,275,53,101,139,429,275,53,101,341,0,0,0,0
6048,r167,All institutions<sup>a</sup> -> Illinois Institute of Technology,All institutions<sup>a</sup>,Illinois Institute of Technology,2,166,427,245,182,0,144,400,232,168,0,217,27,13,14,0
6048,r168,All institutions<sup>a</sup> -> Florida Institute of Technology,All institutions<sup>a</sup>,Florida Institute of Technology,2,167,404,278,126,0,149,382,269,113,0,234,22,9,13,0
6048,r169,All institutions<sup>a</sup> -> U. Southern Mississippi,All institutions<sup>a</sup>,U. Southern Mississippi,2,168,401,258,69,74,174,284,161,69,54,94,117,97,0,20
6048,r170,All institutions<sup>a</sup> -> U. Idaho,All institutions<sup>a</sup>,U. Idaho,2,169,399,280,119,0,171,288,219,69,0,99,111,61,50,0
6048,r171,All institutions<sup>a</sup> -> U. North Dakota,All institutions<sup>a</sup>,U. North Dakota,2,170,398,193,162,43,180,257,135,99,23,73,141,58,63,20
6048,r172,All institutions<sup>a</sup> -> Southern Methodist U.,All institutions<sup>a</sup>,Southern Methodist U.,2,171,396,269,127,0,157,343,241,102,0,158,53,28,25,0
6048,r173,All institutions<sup>a</sup> -> Ohio U.,All institutions<sup>a</sup>,Ohio U.,2,172,395,255,116,24,164,326,232,74,20,141,69,23,42,4
6048,r174,"All institutions<sup>a</sup> -> U. North Carolina, Greensboro",All institutions<sup>a</sup>,"U. North Carolina, Greensboro",2,173,383,204,0,179,215,150,101,0,49,44,233,103,0,130
6048,r175,All institutions<sup>a</sup> -> U. Maine,All institutions<sup>a</sup>,U. Maine,2,174,380,269,111,0,152,367,260,107,0,268,13,9,4,0
6048,r176,All institutions<sup>a</sup> -> Stevens Institute of Technology,All institutions<sup>a</sup>,Stevens Institute of Technology,2,175,374,139,235,0,157,343,131,212,0,202,31,8,23,0
6048,r177,"All institutions<sup>a</sup> -> U. Missouri, Kansas City",All institutions<sup>a</sup>,"U. Missouri, Kansas City",2,176,370,244,60,66,254,80,73,3,4,32,290,171,57,62
6048,r178,All institutions<sup>a</sup> -> New School,All institutions<sup>a</sup>,New School,2,177,369,369,0,0,159,340,340,0,0,208,29,29,0,0
6048,r179,All institutions<sup>a</sup> -> Rochester Institute of Technology,All institutions<sup>a</sup>,Rochester Institute of Technology,2,178,366,245,121,0,161,334,223,111,0,195,32,22,10,0
6048,r180,All institutions<sup>a</sup> -> Brigham Young U.,All institutions<sup>a</sup>,Brigham Young U.,2,179,360,211,147,2,273,63,24,38,1,31,297,187,109,1
6048,r181,All institutions<sup>a</sup> -> Marquette U.,All institutions<sup>a</sup>,Marquette U.,2,180,359,214,101,44,185,238,150,67,21,87,121,64,34,23
6048,r182,All institutions<sup>a</sup> -> Northern Illinois U.,All institutions<sup>a</sup>,Northern Illinois U.,2,181,353,300,1,52,197,192,186,1,5,64,161,114,0,47
6048,r183,"All institutions<sup>a</sup> -> U. Nebraska, Medical Center",All institutions<sup>a</sup>,"U. Nebraska, Medical Center",2,182,334,304,0,30,198,190,171,0,19,69,144,133,0,11
6048,r184,"All institutions<sup>a</sup> -> Columbia U., Teachers C.",All institutions<sup>a</sup>,"Columbia U., Teachers C.",2,183,333,281,0,52,184,254,224,0,30,126,79,57,0,22
6048,r185,"All institutions<sup>a</sup> -> U. Massachusetts, Medical School",All institutions<sup>a</sup>,"U. Massachusetts, Medical School",2,184,330,330,0,0,163,330,330,0,0,341,0,0,0,0
6048,r186,All institutions<sup>a</sup> -> Oakland U.,All institutions<sup>a</sup>,Oakland U.,2,185,320,138,173,9,200,189,100,82,7,76,131,38,91,2
6048,r187,All institutions<sup>a</sup> -> Carlos Albizu U.,All institutions<sup>a</sup>,Carlos Albizu U.,2,186,313,313,0,0,171,288,288,0,0,226,25,25,0,0
6048,r188,All institutions<sup>a</sup> -> Bowling Green State U.,All institutions<sup>a</sup>,Bowling Green State U.,2,187,308,300,0,8,187,232,225,0,7,129,76,75,0,1
6048,r189,"All institutions<sup>a</sup> -> U. Puerto Rico, Rio Piedras",All institutions<sup>a</sup>,"U. Puerto Rico, Rio Piedras",2,188,302,302,0,0,168,292,292,0,0,282,10,10,0,0
6048,r190,All institutions<sup>a</sup> -> Northern Arizona U.,All institutions<sup>a</sup>,Northern Arizona U.,2,189,299,266,33,0,178,265,236,29,0,188,34,30,4,0
6048,r191,"All institutions<sup>a</sup> -> U. Louisiana, Lafayette",All institutions<sup>a</sup>,"U. Louisiana, Lafayette",2,190,293,185,91,17,182,255,171,74,10,178,38,14,17,7
6048,r192,All institutions<sup>a</sup> -> Scripps Research Institute,All institutions<sup>a</sup>,Scripps Research Institute,2,191,291,291,0,0,169,291,291,0,0,341,0,0,0,0
6048,r193,All institutions<sup>a</sup> -> Albert Einstein C. of Medicine,All institutions<sup>a</sup>,Albert Einstein C. of Medicine,2,192,287,283,0,4,173,287,283,0,4,341,0,0,0,0
6048,r194,"All institutions<sup>a</sup> -> U. Alabama, Huntsville",All institutions<sup>a</sup>,"U. Alabama, Huntsville",2,193,282,119,152,11,204,175,86,81,8,101,107,33,71,3
6048,r195,All institutions<sup>a</sup> -> Oregon Health and Science U.,All institutions<sup>a</sup>,Oregon Health and Science U.,2,194,280,191,66,23,177,269,188,63,18,277,11,3,3,5
6048,r196,All institutions<sup>a</sup> -> Wake Forest U.,All institutions<sup>a</sup>,Wake Forest U.,2,195,277,228,49,0,176,275,226,49,0,320,2,2,0,0
6048,r197,All institutions<sup>a</sup> -> North Carolina Agricultural and Technical State U.,All institutions<sup>a</sup>,North Carolina Agricultural and Technical State U.,2,196,276,77,199,0,207,164,54,110,0,97,112,23,89,0
6048,r198,All institutions<sup>a</sup> -> Pontifical Catholic U. Puerto Rico,All institutions<sup>a</sup>,Pontifical Catholic U. Puerto Rico,2,197,273,273,0,0,249,100,100,0,0,58,173,173,0,0
6048,r199,All institutions<sup>a</sup> -> Boise State U.,All institutions<sup>a</sup>,Boise State U.,2,198,266,175,91,0,192,201,128,73,0,145,65,47,18,0
6048,r200,"All institutions<sup>a</sup> -> U. Texas Health Science Center, San Antonio",All institutions<sup>a</sup>,"U. Texas Health Science Center, San Antonio",2,199,260,201,12,47,193,200,188,4,8,149,60,13,8,39
6048,r201,"All institutions<sup>a</sup> -> Mayo Clinic, Mayo Graduate School",All institutions<sup>a</sup>,"Mayo Clinic, Mayo Graduate School",2,200,259,216,43,0,179,259,216,43,0,341,0,0,0,0
6048,r202,All institutions<sup>a</sup> -> Rockefeller U.,All institutions<sup>a</sup>,Rockefeller U.,2,201,255,255,0,0,182,255,255,0,0,341,0,0,0,0
6048,r203,All institutions<sup>a</sup> -> Fordham U.,All institutions<sup>a</sup>,Fordham U.,2,202,254,254,0,0,221,139,139,0,0,95,115,115,0,0
6048,r204,"All institutions<sup>a</sup> -> U. Arkansas, Little Rock",All institutions<sup>a</sup>,"U. Arkansas, Little Rock",2,203,249,226,23,0,227,136,123,13,0,96,113,103,10,0
6048,r205,All institutions<sup>a</sup> -> Medical C. Wisconsin,All institutions<sup>a</sup>,Medical C. Wisconsin,2,204,244,187,34,23,186,233,187,32,14,277,11,0,2,9
6048,r206,All institutions<sup>a</sup> -> American U.,All institutions<sup>a</sup>,American U.,2,205,238,238,0,0,190,216,216,0,0,234,22,22,0,0
6048,r207,All institutions<sup>a</sup> -> A. T. Still U.,All institutions<sup>a</sup>,A. T. Still U.,2,206,232,0,0,232,209,156,0,0,156,129,76,0,0,76
6048,r208,"All institutions<sup>a</sup> -> U. Alaska, Fairbanks",All institutions<sup>a</sup>,"U. Alaska, Fairbanks",2,207,228,210,18,0,251,96,88,8,0,75,132,122,10,0
6048,r209,All institutions<sup>a</sup> -> Loma Linda U.,All institutions<sup>a</sup>,Loma Linda U.,2,208,227,139,0,88,232,126,99,0,27,108,101,40,0,61
6048,r210,All institutions<sup>a</sup> -> South Dakota State U.,All institutions<sup>a</sup>,South Dakota State U.,2,209,224,168,44,12,216,148,111,30,7,129,76,57,14,5
6048,r211,All institutions<sup>a</sup> -> C. of William and Mary,All institutions<sup>a</sup>,C. of William and Mary,2,210,216,216,0,0,196,195,195,0,0,238,21,21,0,0
6048,r212,All institutions<sup>a</sup> -> U. South Dakota,All institutions<sup>a</sup>,U. South Dakota,2,211,213,166,11,36,214,154,135,9,10,151,59,31,2,26
6048,r213,"All institutions<sup>a</sup> -> U. Missouri, Saint Louis",All institutions<sup>a</sup>,"U. Missouri, Saint Louis",2,211,213,183,0,30,223,137,129,0,8,129,76,54,0,22
6048,r214,All institutions<sup>a</sup> -> Seton Hall U.,All institutions<sup>a</sup>,Seton Hall U.,2,213,211,88,0,123,301,42,34,0,8,60,169,54,0,115
6048,r215,All institutions<sup>a</sup> -> Morgan State U.,All institutions<sup>a</sup>,Morgan State U.,2,214,210,59,85,66,195,198,57,77,64,273,12,2,8,2
6048,r216,All institutions<sup>a</sup> -> U. Montana,All institutions<sup>a</sup>,U. Montana,2,215,209,195,0,14,237,116,109,0,7,113,93,86,0,7
6048,r217,All institutions<sup>a</sup> -> U. Denver,All institutions<sup>a</sup>,U. Denver,2,216,207,182,25,0,198,190,167,23,0,254,17,15,2,0
6048,r218,All institutions<sup>a</sup> -> Duquesne U.,All institutions<sup>a</sup>,Duquesne U.,2,217,205,108,0,97,201,182,102,0,80,230,23,6,0,17
6048,r219,All institutions<sup>a</sup> -> East Carolina U.,All institutions<sup>a</sup>,East Carolina U.,2,218,204,168,0,36,206,168,157,0,11,183,36,11,0,25
6048,r220,All institutions<sup>a</sup> -> U. Tulsa,All institutions<sup>a</sup>,U. Tulsa,2,219,203,127,76,0,191,203,127,76,0,341,0,0,0,0
6048,r221,All institutions<sup>a</sup> -> Wright State U.,All institutions<sup>a</sup>,Wright State U.,2,219,203,108,95,0,217,142,79,63,0,147,61,29,32,0
6048,r222,"All institutions<sup>a</sup> -> Keiser U., Fort Lauderdale",All institutions<sup>a</sup>,"Keiser U., Fort Lauderdale",2,219,203,203,0,0,236,117,117,0,0,117,86,86,0,0
6048,r223,All institutions<sup>a</sup> -> U. South Alabama,All institutions<sup>a</sup>,U. South Alabama,2,222,201,171,23,7,205,171,150,14,7,205,30,21,9,0
6048,r224,"All institutions<sup>a</sup> -> U. Tennessee, Health Science Center",All institutions<sup>a</sup>,"U. Tennessee, Health Science Center",2,223,200,133,2,65,193,200,133,2,65,341,0,0,0,0
6048,r225,All institutions<sup>a</sup> -> Antioch U.,All institutions<sup>a</sup>,Antioch U.,2,224,199,199,0,0,211,155,155,0,0,172,44,44,0,0
6048,r226,All institutions<sup>a</sup> -> Wichita State U.,All institutions<sup>a</sup>,Wichita State U.,2,224,199,108,86,5,253,89,61,26,2,100,110,47,60,3
6048,r227,All institutions<sup>a</sup> -> U. Texas Medical Branch,All institutions<sup>a</sup>,U. Texas Medical Branch,2,226,187,177,0,10,209,156,150,0,6,202,31,27,0,4
6048,r228,All institutions<sup>a</sup> -> Long Island U.,All institutions<sup>a</sup>,Long Island U.,2,227,186,152,0,34,268,68,59,0,9,92,118,93,0,25
6048,r229,All institutions<sup>a</sup> -> Miami U.,All institutions<sup>a</sup>,Miami U.,2,228,185,185,0,0,202,181,181,0,0,310,4,4,0,0
6048,r230,"All institutions<sup>a</sup> -> Loyola U., Chicago",All institutions<sup>a</sup>,"Loyola U., Chicago",2,228,185,185,0,0,203,179,179,0,0,296,6,6,0,0
6048,r231,All institutions<sup>a</sup> -> Louisiana Tech U.,All institutions<sup>a</sup>,Louisiana Tech U.,2,230,183,109,74,0,227,136,73,63,0,167,47,36,11,0
6048,r232,"All institutions<sup>a</sup> -> St. John's U., Queens",All institutions<sup>a</sup>,"St. John's U., Queens",2,231,181,78,0,103,242,105,63,0,42,129,76,15,0,61
6048,r233,All institutions<sup>a</sup> -> Catholic U. of America,All institutions<sup>a</sup>,Catholic U. of America,2,232,179,107,72,0,218,141,78,63,0,178,38,29,9,0
6048,r234,"All institutions<sup>a</sup> -> U. Massachusetts, Dartmouth",All institutions<sup>a</sup>,"U. Massachusetts, Dartmouth",2,233,176,88,62,26,266,69,33,36,0,101,107,55,26,26
6048,r235,All institutions<sup>a</sup> -> Texas State U.,All institutions<sup>a</sup>,Texas State U.,2,234,175,131,44,0,230,128,92,36,0,167,47,39,8,0
6048,r236,All institutions<sup>a</sup> -> Cleveland State U.,All institutions<sup>a</sup>,Cleveland State U.,2,235,173,105,68,0,222,138,86,52,0,187,35,19,16,0
6048,r237,All institutions<sup>a</sup> -> Idaho State U.,All institutions<sup>a</sup>,Idaho State U.,2,235,173,105,41,27,242,105,74,15,16,142,68,31,26,11
6048,r238,All institutions<sup>a</sup> -> U. Arkansas for Medical Sciences,All institutions<sup>a</sup>,U. Arkansas for Medical Sciences,2,237,171,97,0,74,240,109,78,0,31,146,62,19,0,43
6048,r239,All institutions<sup>a</sup> -> Central Michigan U.,All institutions<sup>a</sup>,Central Michigan U.,2,238,167,167,0,0,268,68,68,0,0,110,99,99,0,0
6048,r240,"All institutions<sup>a</sup> -> U. Puerto Rico, Mayaguez",All institutions<sup>a</sup>,"U. Puerto Rico, Mayaguez",2,239,166,61,105,0,208,158,59,99,0,288,8,2,6,0
6048,r241,All institutions<sup>a</sup> -> Medical U. South Carolina,All institutions<sup>a</sup>,Medical U. South Carolina,2,240,163,121,0,42,219,140,121,0,19,230,23,0,0,23
6048,r242,All institutions<sup>a</sup> -> Jackson State U.,All institutions<sup>a</sup>,Jackson State U.,2,241,161,69,18,74,297,43,30,8,5,92,118,39,10,69
6048,r243,"All institutions<sup>a</sup> -> U. Puerto Rico, Medical Sciences Campus",All institutions<sup>a</sup>,"U. Puerto Rico, Medical Sciences Campus",2,242,160,77,0,83,219,140,70,0,70,243,20,7,0,13
6048,r244,All institutions<sup>a</sup> -> Dakota State U.,All institutions<sup>a</sup>,Dakota State U.,2,243,157,157,0,0,250,98,98,0,0,151,59,59,0,0
6048,r245,All institutions<sup>a</sup> -> Clarkson U.,All institutions<sup>a</sup>,Clarkson U.,2,244,156,70,86,0,211,155,70,85,0,333,1,0,1,0
6048,r246,All institutions<sup>a</sup> -> U. New Orleans,All institutions<sup>a</sup>,U. New Orleans,2,245,155,96,59,0,246,103,64,39,0,159,52,32,20,0
6048,r247,All institutions<sup>a</sup> -> East Tennessee State U.,All institutions<sup>a</sup>,East Tennessee State U.,2,246,149,73,0,76,244,104,59,0,45,171,45,14,0,31
6048,r248,All institutions<sup>a</sup> -> Florida A&M U.,All institutions<sup>a</sup>,Florida A&M U.,2,247,145,50,54,41,231,127,43,50,34,251,18,7,4,7
6048,r249,All institutions<sup>a</sup> -> Air Force Institute of Technology,All institutions<sup>a</sup>,Air Force Institute of Technology,2,247,145,34,111,0,234,123,26,97,0,234,22,8,14,0
6048,r250,All institutions<sup>a</sup> -> DePaul U.,All institutions<sup>a</sup>,DePaul U.,2,249,143,143,0,0,281,51,51,0,0,115,92,92,0,0
6048,r251,"All institutions<sup>a</sup> -> CUNY, City C.",All institutions<sup>a</sup>,"CUNY, City C.",2,250,142,0,142,0,223,137,0,137,0,303,5,0,5,0
6048,r252,All institutions<sup>a</sup> -> Uniformed Services U. of the Health Sciences,All institutions<sup>a</sup>,Uniformed Services U. of the Health Sciences,2,251,140,128,0,12,223,137,125,0,12,317,3,3,0,0
6048,r253,All institutions<sup>a</sup> -> Rush U.,All institutions<sup>a</sup>,Rush U.,2,251,140,11,47,82,254,80,11,47,22,149,60,0,0,60
6048,r254,All institutions<sup>a</sup> -> Adelphi U.,All institutions<sup>a</sup>,Adelphi U.,2,253,139,104,0,35,319,27,21,0,6,97,112,83,0,29
6048,r255,All institutions<sup>a</sup> -> U. Dayton,All institutions<sup>a</sup>,U. Dayton,2,254,137,12,125,0,223,137,12,125,0,341,0,0,0,0
6048,r256,All institutions<sup>a</sup> -> Thomas Jefferson U.,All institutions<sup>a</sup>,Thomas Jefferson U.,2,255,135,135,0,0,229,135,135,0,0,341,0,0,0,0
6048,r257,All institutions<sup>a</sup> -> Barry U.,All institutions<sup>a</sup>,Barry U.,2,256,133,48,0,85,283,48,33,0,15,120,85,15,0,70
6048,r258,All institutions<sup>a</sup> -> Tennessee Technological U.,All institutions<sup>a</sup>,Tennessee Technological U.,2,257,129,25,104,0,331,22,4,18,0,101,107,21,86,0
6048,r259,All institutions<sup>a</sup> -> Augusta U.,All institutions<sup>a</sup>,Augusta U.,2,258,128,84,0,44,244,104,83,0,21,228,24,1,0,23
6048,r260,All institutions<sup>a</sup> -> Montclair State U.,All institutions<sup>a</sup>,Montclair State U.,2,259,127,122,0,5,241,108,104,0,4,248,19,18,0,1
6048,r261,All institutions<sup>a</sup> -> Clark U.,All institutions<sup>a</sup>,Clark U.,2,260,126,126,0,0,233,125,125,0,0,333,1,1,0,0
6048,r262,All institutions<sup>a</sup> -> Nova Southeastern U.,All institutions<sup>a</sup>,Nova Southeastern U.,2,261,125,125,0,0,278,53,53,0,0,138,72,72,0,0
6048,r263,All institutions<sup>a</sup> -> Marymount U.,All institutions<sup>a</sup>,Marymount U.,2,261,125,125,0,0,342,18,18,0,0,101,107,107,0,0
6048,r264,All institutions<sup>a</sup> -> Embry-Riddle Aeronautical U.,All institutions<sup>a</sup>,Embry-Riddle Aeronautical U.,2,263,124,20,104,0,238,115,18,97,0,284,9,2,7,0
6048,r265,All institutions<sup>a</sup> -> Frederick S. Pardee RAND Graduate School,All institutions<sup>a</sup>,Frederick S. Pardee RAND Graduate School,2,264,123,123,0,0,234,123,123,0,0,341,0,0,0,0
6048,r266,All institutions<sup>a</sup> -> Rowan U.,All institutions<sup>a</sup>,Rowan U.,2,265,122,39,83,0,247,102,39,63,0,243,20,0,20,0
6048,r267,All institutions<sup>a</sup> -> Ball State U.,All institutions<sup>a</sup>,Ball State U.,2,265,122,122,0,0,262,74,74,0,0,166,48,48,0,0
6048,r268,All institutions<sup>a</sup> -> Hofstra U.,All institutions<sup>a</sup>,Hofstra U.,2,267,113,113,0,0,247,102,102,0,0,277,11,11,0,0
6048,r269,"All institutions<sup>a</sup> -> SUNY, Upstate Medical U.",All institutions<sup>a</sup>,"SUNY, Upstate Medical U.",2,268,110,110,0,0,239,110,110,0,0,341,0,0,0,0
6048,r270,All institutions<sup>a</sup> -> U. Northern Colorado,All institutions<sup>a</sup>,U. Northern Colorado,2,268,110,34,0,76,310,35,19,0,16,134,75,15,0,60
6048,r271,All institutions<sup>a</sup> -> Massachusetts C. of Pharmacy and Health Sciences,All institutions<sup>a</sup>,Massachusetts C. of Pharmacy and Health Sciences,2,270,108,9,0,99,331,22,7,0,15,117,86,2,0,84
6048,r272,All institutions<sup>a</sup> -> Tennessee State U.,All institutions<sup>a</sup>,Tennessee State U.,2,271,106,88,18,0,262,74,66,8,0,195,32,22,10,0
6048,r273,All institutions<sup>a</sup> -> Southern U. and A&M C.,All institutions<sup>a</sup>,Southern U. and A&M C.,2,272,103,101,0,2,274,61,59,0,2,173,42,42,0,0
6048,r274,All institutions<sup>a</sup> -> U. Indianapolis,All institutions<sup>a</sup>,U. Indianapolis,2,273,97,0,0,97,344,16,0,0,16,124,81,0,0,81
6048,r275,"All institutions<sup>a</sup> -> U. Michigan, Flint",All institutions<sup>a</sup>,"U. Michigan, Flint",2,274,91,0,0,91,254,80,0,0,80,277,11,0,0,11
6048,r276,All institutions<sup>a</sup> -> Yeshiva U.,All institutions<sup>a</sup>,Yeshiva U.,2,274,91,91,0,0,271,65,65,0,0,221,26,26,0,0
6048,r277,"All institutions<sup>a</sup> -> City of Hope, Irell and Manella Graduate School of Biological Sciences",All institutions<sup>a</sup>,"City of Hope, Irell and Manella Graduate School of Biological Sciences",2,276,90,90,0,0,252,90,90,0,0,341,0,0,0,0
6048,r278,All institutions<sup>a</sup> -> New Mexico Institute of Mining and Technology,All institutions<sup>a</sup>,New Mexico Institute of Mining and Technology,2,277,89,63,26,0,264,71,54,17,0,251,18,9,9,0
6048,r279,All institutions<sup>a</sup> -> Clark Atlanta U.,All institutions<sup>a</sup>,Clark Atlanta U.,2,277,89,89,0,0,297,43,43,0,0,169,46,46,0,0
6048,r280,All institutions<sup>a</sup> -> Illinois State U.,All institutions<sup>a</sup>,Illinois State U.,2,279,88,75,0,13,266,69,69,0,0,248,19,6,0,13
6048,r281,All institutions<sup>a</sup> -> Chapman U.,All institutions<sup>a</sup>,Chapman U.,2,279,88,55,0,33,289,46,18,0,28,173,42,37,0,5
6048,r282,All institutions<sup>a</sup> -> National Louis U.,All institutions<sup>a</sup>,National Louis U.,2,281,86,86,0,0,278,53,53,0,0,192,33,33,0,0
6048,r283,"All institutions<sup>a</sup> -> U. North Texas, Health Science Center",All institutions<sup>a</sup>,"U. North Texas, Health Science Center",2,282,85,72,0,13,258,78,72,0,6,294,7,0,0,7
6048,r284,"All institutions<sup>a</sup> -> Oklahoma State U., Center for Health Sciences",All institutions<sup>a</sup>,"Oklahoma State U., Center for Health Sciences",2,283,83,83,0,0,272,64,64,0,0,248,19,19,0,0
6048,r285,All institutions<sup>a</sup> -> Texas Christian U.,All institutions<sup>a</sup>,Texas Christian U.,2,284,80,68,0,12,260,76,68,0,8,310,4,0,0,4
6048,r286,All institutions<sup>a</sup> -> Texas A&M U.-Corpus Christi,All institutions<sup>a</sup>,Texas A&M U.-Corpus Christi,2,284,80,80,0,0,270,67,67,0,0,268,13,13,0,0
6048,r287,All institutions<sup>a</sup> -> Lamar U.,All institutions<sup>a</sup>,Lamar U.,2,284,80,0,80,0,286,47,0,47,0,192,33,0,33,0
6048,r288,All institutions<sup>a</sup> -> Memorial Sloan Kettering Cancer Center,All institutions<sup>a</sup>,Memorial Sloan Kettering Cancer Center,2,287,79,79,0,0,257,79,79,0,0,341,0,0,0,0
6048,r289,All institutions<sup>a</sup> -> California Institute of Integral Studies,All institutions<sup>a</sup>,California Institute of Integral Studies,2,287,79,79,0,0,261,75,75,0,0,310,4,4,0,0
6048,r290,All institutions<sup>a</sup> -> Pace U.,All institutions<sup>a</sup>,Pace U.,2,287,79,44,0,35,297,43,19,0,24,183,36,25,0,11
6048,r291,All institutions<sup>a</sup> -> Arkansas State U.,All institutions<sup>a</sup>,Arkansas State U.,2,290,74,74,0,0,307,38,38,0,0,183,36,36,0,0
6048,r292,All institutions<sup>a</sup> -> Kennesaw State U.,All institutions<sup>a</sup>,Kennesaw State U.,2,291,71,71,0,0,290,45,45,0,0,221,26,26,0,0
6048,r293,All institutions<sup>a</sup> -> Wesleyan U.,All institutions<sup>a</sup>,Wesleyan U.,2,292,70,70,0,0,265,70,70,0,0,341,0,0,0,0
6048,r294,All institutions<sup>a</sup> -> William Carey U.,All institutions<sup>a</sup>,William Carey U.,2,292,70,0,0,70,305,39,0,0,39,202,31,0,0,31
6048,r295,All institutions<sup>a</sup> -> Villanova U.,All institutions<sup>a</sup>,Villanova U.,2,294,69,0,69,0,303,40,0,40,0,208,29,0,29,0
6048,r296,"All institutions<sup>a</sup> -> SUNY, Polytechnic Institute",All institutions<sup>a</sup>,"SUNY, Polytechnic Institute",2,295,67,1,66,0,305,39,1,38,0,213,28,0,28,0
6048,r297,All institutions<sup>a</sup> -> Towson U.,All institutions<sup>a</sup>,Towson U.,2,296,63,63,0,0,282,49,49,0,0,261,14,14,0,0
6048,r298,All institutions<sup>a</sup> -> Endicott C.,All institutions<sup>a</sup>,Endicott C.,2,297,62,41,0,21,328,23,23,0,0,176,39,18,0,21
6048,r299,All institutions<sup>a</sup> -> Suffolk U.,All institutions<sup>a</sup>,Suffolk U.,2,298,61,48,0,13,303,40,27,0,13,238,21,21,0,0
6048,r300,All institutions<sup>a</sup> -> Naval Postgraduate School,All institutions<sup>a</sup>,Naval Postgraduate School,2,299,59,34,25,0,275,59,34,25,0,341,0,0,0,0
6048,r301,All institutions<sup>a</sup> -> U. San Diego,All institutions<sup>a</sup>,U. San Diego,2,299,59,0,0,59,382,1,0,0,1,153,58,0,0,58
6048,r302,All institutions<sup>a</sup> -> Andrews U.,All institutions<sup>a</sup>,Andrews U.,2,301,58,58,0,0,276,56,56,0,0,320,2,2,0,0
6048,r303,All institutions<sup>a</sup> -> Azusa Pacific U.,All institutions<sup>a</sup>,Azusa Pacific U.,2,302,57,0,0,57,286,47,0,0,47,282,10,0,0,10
6048,r304,"All institutions<sup>a</sup> -> U. Nebraska, Omaha",All institutions<sup>a</sup>,"U. Nebraska, Omaha",2,303,56,33,0,23,319,27,14,0,13,208,29,19,0,10
6048,r305,All institutions<sup>a</sup> -> Albany Medical C.,All institutions<sup>a</sup>,Albany Medical C.,2,304,54,54,0,0,277,54,54,0,0,341,0,0,0,0
6048,r306,All institutions<sup>a</sup> -> Santa Clara U.,All institutions<sup>a</sup>,Santa Clara U.,2,305,53,0,53,0,334,21,0,21,0,195,32,0,32,0
6048,r307,All institutions<sup>a</sup> -> Cold Spring Harbor Laboratory,All institutions<sup>a</sup>,Cold Spring Harbor Laboratory,2,306,52,52,0,0,280,52,52,0,0,341,0,0,0,0
6048,r308,"All institutions<sup>a</sup> -> SUNY, Downstate Medical Center",All institutions<sup>a</sup>,"SUNY, Downstate Medical Center",2,306,52,43,9,0,283,48,40,8,0,310,4,3,1,0
6048,r309,All institutions<sup>a</sup> -> Mercer U.,All institutions<sup>a</sup>,Mercer U.,2,306,52,0,0,52,302,41,0,0,41,277,11,0,0,11
6048,r310,All institutions<sup>a</sup> -> Bowie State U.,All institutions<sup>a</sup>,Bowie State U.,2,306,52,52,0,0,316,28,28,0,0,228,24,24,0,0
6048,r311,All institutions<sup>a</sup> -> Tuskegee U.,All institutions<sup>a</sup>,Tuskegee U.,2,310,51,44,7,0,290,45,38,7,0,296,6,6,0,0
6048,r312,All institutions<sup>a</sup> -> Pacific U.,All institutions<sup>a</sup>,Pacific U.,2,310,51,51,0,0,297,43,43,0,0,288,8,8,0,0
6048,r313,All institutions<sup>a</sup> -> U. del Turabo,All institutions<sup>a</sup>,U. del Turabo,2,310,51,51,0,0,361,9,9,0,0,173,42,42,0,0
6048,r314,All institutions<sup>a</sup> -> Biola U.,All institutions<sup>a</sup>,Biola U.,2,313,49,49,0,0,283,48,48,0,0,333,1,1,0,0
6048,r315,All institutions<sup>a</sup> -> Niagara U.,All institutions<sup>a</sup>,Niagara U.,2,313,49,49,0,0,316,28,28,0,0,238,21,21,0,0
6048,r316,All institutions<sup>a</sup> -> Middle Tennessee State U.,All institutions<sup>a</sup>,Middle Tennessee State U.,2,313,49,49,0,0,356,12,12,0,0,181,37,37,0,0
6048,r317,All institutions<sup>a</sup> -> Sam Houston State U.,All institutions<sup>a</sup>,Sam Houston State U.,2,316,48,48,0,0,337,20,20,0,0,213,28,28,0,0
6048,r318,All institutions<sup>a</sup> -> Marshall U.,All institutions<sup>a</sup>,Marshall U.,2,317,47,47,0,0,286,47,47,0,0,341,0,0,0,0
6048,r319,All institutions<sup>a</sup> -> Delaware State U.,All institutions<sup>a</sup>,Delaware State U.,2,318,46,46,0,0,294,44,44,0,0,320,2,2,0,0
6048,r320,All institutions<sup>a</sup> -> Gallaudet U.,All institutions<sup>a</sup>,Gallaudet U.,2,318,46,38,0,8,321,26,21,0,5,243,20,17,0,3
6048,r321,All institutions<sup>a</sup> -> Prairie View A&M U.,All institutions<sup>a</sup>,Prairie View A&M U.,2,318,46,11,35,0,354,13,2,11,0,192,33,9,24,0
6048,r322,All institutions<sup>a</sup> -> Cedars-Sinai Medical Center,All institutions<sup>a</sup>,Cedars-Sinai Medical Center,2,321,45,45,0,0,290,45,45,0,0,341,0,0,0,0
6048,r323,All institutions<sup>a</sup> -> Western New England U.,All institutions<sup>a</sup>,Western New England U.,2,321,45,45,0,0,290,45,45,0,0,341,0,0,0,0
6048,r324,All institutions<sup>a</sup> -> Morehouse School of Medicine,All institutions<sup>a</sup>,Morehouse School of Medicine,2,321,45,45,0,0,294,44,44,0,0,333,1,1,0,0
6048,r325,"All institutions<sup>a</sup> -> U. Texas, Tyler",All institutions<sup>a</sup>,"U. Texas, Tyler",2,321,45,8,0,37,354,13,7,0,6,195,32,1,0,31
6048,r326,"All institutions<sup>a</sup> -> Toyota Technological Institute, Chicago",All institutions<sup>a</sup>,"Toyota Technological Institute, Chicago",2,325,44,44,0,0,294,44,44,0,0,341,0,0,0,0
6048,r327,All institutions<sup>a</sup> -> James Madison U.,All institutions<sup>a</sup>,James Madison U.,2,325,44,44,0,0,309,36,36,0,0,288,8,8,0,0
6048,r328,All institutions<sup>a</sup> -> Texas A&M U.-Kingsville,All institutions<sup>a</sup>,Texas A&M U.-Kingsville,2,325,44,16,28,0,331,22,13,9,0,234,22,3,19,0
6048,r329,"All institutions<sup>a</sup> -> U. Maryland, Eastern Shore",All institutions<sup>a</sup>,"U. Maryland, Eastern Shore",2,325,44,37,0,7,371,5,4,0,1,176,39,33,0,6
6048,r330,All institutions<sup>a</sup> -> Widener U.,All institutions<sup>a</sup>,Widener U.,2,329,43,0,0,43,347,15,0,0,15,213,28,0,0,28
6048,r331,All institutions<sup>a</sup> -> U. Central Arkansas,All institutions<sup>a</sup>,U. Central Arkansas,2,330,41,32,0,9,337,20,20,0,0,238,21,12,0,9
6048,r332,All institutions<sup>a</sup> -> Van Andel Institute,All institutions<sup>a</sup>,Van Andel Institute,2,331,38,38,0,0,307,38,38,0,0,341,0,0,0,0
6048,r333,All institutions<sup>a</sup> -> Bryn Mawr C.,All institutions<sup>a</sup>,Bryn Mawr C.,2,332,35,35,0,0,311,34,34,0,0,333,1,1,0,0
6048,r334,All institutions<sup>a</sup> -> Meharry Medical C.,All institutions<sup>a</sup>,Meharry Medical C.,2,333,34,34,0,0,311,34,34,0,0,341,0,0,0,0
6048,r335,All institutions<sup>a</sup> -> Texas Southern U.,All institutions<sup>a</sup>,Texas Southern U.,2,334,33,21,0,12,326,24,16,0,8,284,9,5,0,4
6048,r336,All institutions<sup>a</sup> -> Alabama A&M U.,All institutions<sup>a</sup>,Alabama A&M U.,2,334,33,33,0,0,337,20,20,0,0,268,13,13,0,0
6048,r337,"All institutions<sup>a</sup> -> U. Tennessee, Chattanooga",All institutions<sup>a</sup>,"U. Tennessee, Chattanooga",2,334,33,33,0,0,340,19,19,0,0,261,14,14,0,0
6048,r338,All institutions<sup>a</sup> -> Texas A&M U.-Commerce,All institutions<sup>a</sup>,Texas A&M U.-Commerce,2,334,33,33,0,0,366,7,7,0,0,221,26,26,0,0
6048,r339,All institutions<sup>a</sup> -> Sanford-Burnham Medical Research Institute,All institutions<sup>a</sup>,Sanford-Burnham Medical Research Institute,2,338,32,32,0,0,313,32,32,0,0,341,0,0,0,0
6048,r340,All institutions<sup>a</sup> -> American International C.,All institutions<sup>a</sup>,American International C.,2,338,32,32,0,0,321,26,26,0,0,296,6,6,0,0
6048,r341,All institutions<sup>a</sup> -> Molloy C.,All institutions<sup>a</sup>,Molloy C.,2,338,32,0,0,32,388,0,0,0,0,195,32,0,0,32
6048,r342,All institutions<sup>a</sup> -> Robert Morris U.,All institutions<sup>a</sup>,Robert Morris U.,2,338,32,32,0,0,388,0,0,0,0,195,32,32,0,0
6048,r343,All institutions<sup>a</sup> -> U. West Georgia,All institutions<sup>a</sup>,U. West Georgia,2,342,31,31,0,0,340,19,19,0,0,273,12,12,0,0
6048,r344,All institutions<sup>a</sup> -> Stephen F. Austin State U.,All institutions<sup>a</sup>,Stephen F. Austin State U.,2,342,31,31,0,0,359,10,10,0,0,238,21,21,0,0
6048,r345,All institutions<sup>a</sup> -> Drew U.,All institutions<sup>a</sup>,Drew U.,2,342,31,0,0,31,372,4,0,0,4,217,27,0,0,27
6048,r346,"All institutions<sup>a</sup> -> California State U., Los Angeles",All institutions<sup>a</sup>,"California State U., Los Angeles",2,345,30,0,0,30,314,30,0,0,30,341,0,0,0,0
6048,r347,All institutions<sup>a</sup> -> New York Medical C.,All institutions<sup>a</sup>,New York Medical C.,2,345,30,30,0,0,314,30,30,0,0,341,0,0,0,0
6048,r348,"All institutions<sup>a</sup> -> U. Louisiana, Monroe",All institutions<sup>a</sup>,"U. Louisiana, Monroe",2,345,30,0,0,30,316,28,0,0,28,320,2,0,0,2
6048,r349,All institutions<sup>a</sup> -> New Jersey City U.,All institutions<sup>a</sup>,New Jersey City U.,2,345,30,30,0,0,388,0,0,0,0,205,30,30,0,0
6048,r350,"All institutions<sup>a</sup> -> U. Alaska, Anchorage",All institutions<sup>a</sup>,"U. Alaska, Anchorage",2,349,28,28,0,0,328,23,23,0,0,303,5,5,0,0
6048,r351,All institutions<sup>a</sup> -> Hampton U.,All institutions<sup>a</sup>,Hampton U.,2,349,28,15,0,13,351,14,14,0,0,261,14,1,0,13
6048,r352,All institutions<sup>a</sup> -> Xavier U.,All institutions<sup>a</sup>,Xavier U.,2,349,28,0,0,28,382,1,0,0,1,217,27,0,0,27
6048,r353,All institutions<sup>a</sup> -> Creighton U.,All institutions<sup>a</sup>,Creighton U.,2,352,27,27,0,0,321,26,26,0,0,333,1,1,0,0
6048,r354,All institutions<sup>a</sup> -> Indiana State U.,All institutions<sup>a</sup>,Indiana State U.,2,352,27,27,0,0,324,25,25,0,0,320,2,2,0,0
6048,r355,All institutions<sup>a</sup> -> U. Central del Caribe,All institutions<sup>a</sup>,U. Central del Caribe,2,354,25,25,0,0,324,25,25,0,0,341,0,0,0,0
6048,r356,All institutions<sup>a</sup> -> U. Detroit Mercy,All institutions<sup>a</sup>,U. Detroit Mercy,2,354,25,0,25,0,328,23,0,23,0,320,2,0,2,0
6048,r357,All institutions<sup>a</sup> -> Wilkes U.,All institutions<sup>a</sup>,Wilkes U.,2,354,25,0,0,25,388,0,0,0,0,226,25,0,0,25
6048,r358,All institutions<sup>a</sup> -> Rosalind Franklin U. of Medicine and Science,All institutions<sup>a</sup>,Rosalind Franklin U. of Medicine and Science,2,357,24,24,0,0,326,24,24,0,0,341,0,0,0,0
6048,r359,"All institutions<sup>a</sup> -> U. North Carolina, Wilmington",All institutions<sup>a</sup>,"U. North Carolina, Wilmington",2,357,24,24,0,0,334,21,21,0,0,317,3,3,0,0
6048,r360,All institutions<sup>a</sup> -> Polytechnic U. Puerto Rico,All institutions<sup>a</sup>,Polytechnic U. Puerto Rico,2,357,24,0,24,0,372,4,0,4,0,243,20,0,20,0
6048,r361,All institutions<sup>a</sup> -> U. Dallas,All institutions<sup>a</sup>,U. Dallas,2,360,22,22,0,0,343,17,17,0,0,303,5,5,0,0
6048,r362,All institutions<sup>a</sup> -> Montana Tech of U. Montana,All institutions<sup>a</sup>,Montana Tech of U. Montana,2,361,21,16,5,0,334,21,16,5,0,341,0,0,0,0
6048,r363,All institutions<sup>a</sup> -> Oklahoma City U.,All institutions<sup>a</sup>,Oklahoma City U.,2,362,19,0,0,19,369,6,0,0,6,268,13,0,0,13
6048,r364,All institutions<sup>a</sup> -> Caldwell U.,All institutions<sup>a</sup>,Caldwell U.,2,362,19,19,0,0,382,1,1,0,0,251,18,18,0,0
6048,r365,All institutions<sup>a</sup> -> Alfred U.,All institutions<sup>a</sup>,Alfred U.,2,364,18,0,18,0,344,16,0,16,0,320,2,0,2,0
6048,r366,All institutions<sup>a</sup> -> Virginia State U.,All institutions<sup>a</sup>,Virginia State U.,2,364,18,18,0,0,359,10,10,0,0,288,8,8,0,0
6048,r367,All institutions<sup>a</sup> -> North Carolina Central U.,All institutions<sup>a</sup>,North Carolina Central U.,2,366,17,17,0,0,347,15,15,0,0,320,2,2,0,0
6048,r368,All institutions<sup>a</sup> -> Norfolk State U.,All institutions<sup>a</sup>,Norfolk State U.,2,367,16,16,0,0,344,16,16,0,0,341,0,0,0,0
6048,r369,All institutions<sup>a</sup> -> Lawrence Technological U.,All institutions<sup>a</sup>,Lawrence Technological U.,2,367,16,0,16,0,382,1,0,1,0,259,15,0,15,0
6048,r370,All institutions<sup>a</sup> -> American Museum of Natural History,All institutions<sup>a</sup>,American Museum of Natural History,2,369,15,15,0,0,347,15,15,0,0,341,0,0,0,0
6048,r371,All institutions<sup>a</sup> -> Keck Graduate Institute,All institutions<sup>a</sup>,Keck Graduate Institute,2,369,15,15,0,0,347,15,15,0,0,341,0,0,0,0
6048,r372,All institutions<sup>a</sup> -> Maharishi U. of Management,All institutions<sup>a</sup>,Maharishi U. of Management,2,371,14,14,0,0,351,14,14,0,0,341,0,0,0,0
6048,r373,"All institutions<sup>a</sup> -> SUNY, C. of Optometry",All institutions<sup>a</sup>,"SUNY, C. of Optometry",2,371,14,14,0,0,351,14,14,0,0,341,0,0,0,0
6048,r374,All institutions<sup>a</sup> -> U. of the District of Columbia,All institutions<sup>a</sup>,U. of the District of Columbia,2,371,14,14,0,0,364,8,8,0,0,296,6,6,0,0
6048,r375,All institutions<sup>a</sup> -> Tarleton State U.,All institutions<sup>a</sup>,Tarleton State U.,2,374,12,12,0,0,356,12,12,0,0,341,0,0,0,0
6048,r376,All institutions<sup>a</sup> -> Youngstown State U.,All institutions<sup>a</sup>,Youngstown State U.,2,374,12,12,0,0,356,12,12,0,0,341,0,0,0,0
6048,r377,All institutions<sup>a</sup> -> West Texas A&M U.,All institutions<sup>a</sup>,West Texas A&M U.,2,374,12,12,0,0,364,8,8,0,0,310,4,4,0,0
6048,r378,All institutions<sup>a</sup> -> Salus U.,All institutions<sup>a</sup>,Salus U.,2,374,12,12,0,0,366,7,7,0,0,303,5,5,0,0
6048,r379,"All institutions<sup>a</sup> -> Inter American U. Puerto Rico, San German",All institutions<sup>a</sup>,"Inter American U. Puerto Rico, San German",2,374,12,12,0,0,388,0,0,0,0,273,12,12,0,0
6048,r380,All institutions<sup>a</sup> -> Indiana U. Pennsylvania,All institutions<sup>a</sup>,Indiana U. Pennsylvania,2,379,11,11,0,0,374,3,3,0,0,288,8,8,0,0
6048,r381,All institutions<sup>a</sup> -> Coastal Carolina U.,All institutions<sup>a</sup>,Coastal Carolina U.,2,380,10,10,0,0,376,2,2,0,0,288,8,8,0,0
6048,r382,"All institutions<sup>a</sup> -> California State U., Long Beach",All institutions<sup>a</sup>,"California State U., Long Beach",2,380,10,0,10,0,382,1,0,1,0,284,9,0,9,0
6048,r383,All institutions<sup>a</sup> -> Elmezzi Graduate School of Molecular Medicine,All institutions<sup>a</sup>,Elmezzi Graduate School of Molecular Medicine,2,382,9,9,0,0,361,9,9,0,0,341,0,0,0,0
6048,r384,All institutions<sup>a</sup> -> Lake Erie C. of Osteopathic Medicine,All institutions<sup>a</sup>,Lake Erie C. of Osteopathic Medicine,2,382,9,9,0,0,361,9,9,0,0,341,0,0,0,0
6048,r385,All institutions<sup>a</sup> -> Rivier U.,All institutions<sup>a</sup>,Rivier U.,2,384,8,8,0,0,376,2,2,0,0,296,6,6,0,0
6048,r386,All institutions<sup>a</sup> -> Springfield C.,All institutions<sup>a</sup>,Springfield C.,2,385,7,7,0,0,366,7,7,0,0,341,0,0,0,0
6048,r387,"All institutions<sup>a</sup> -> U. Hawaii, Hilo",All institutions<sup>a</sup>,"U. Hawaii, Hilo",2,385,7,0,0,7,376,2,0,0,2,303,5,0,0,5
6048,r388,"All institutions<sup>a</sup> -> Northeastern Ohio Universities, C. of Medicine",All institutions<sup>a</sup>,"Northeastern Ohio Universities, C. of Medicine",2,387,6,0,0,6,369,6,0,0,6,341,0,0,0,0
6048,r389,All institutions<sup>a</sup> -> Alabama State U.,All institutions<sup>a</sup>,Alabama State U.,2,387,6,6,0,0,382,1,1,0,0,303,5,5,0,0
6048,r390,All institutions<sup>a</sup> -> Lincoln Memorial U.,All institutions<sup>a</sup>,Lincoln Memorial U.,2,389,4,4,0,0,376,2,2,0,0,320,2,2,0,0
6048,r391,"All institutions<sup>a</sup> -> U. Arkansas, Pine Bluff",All institutions<sup>a</sup>,"U. Arkansas, Pine Bluff",2,389,4,4,0,0,376,2,2,0,0,320,2,2,0,0
6048,r392,All institutions<sup>a</sup> -> Sage Colleges,All institutions<sup>a</sup>,Sage Colleges,2,389,4,0,0,4,388,0,0,0,0,310,4,0,0,4
6048,r393,All institutions<sup>a</sup> -> Western Illinois U.,All institutions<sup>a</sup>,Western Illinois U.,2,392,3,3,0,0,374,3,3,0,0,341,0,0,0,0
6048,r394,All institutions<sup>a</sup> -> U. of the Incarnate Word,All institutions<sup>a</sup>,U. of the Incarnate Word,2,393,2,2,0,0,376,2,2,0,0,341,0,0,0,0
6048,r395,All institutions<sup>a</sup> -> Kean U.,All institutions<sup>a</sup>,Kean U.,2,394,1,0,0,1,388,0,0,0,0,333,1,0,0,1
