table_id,row_id,_b_state_and_department_or_agency_b_full_path,_b_state_and_department_or_agency_b_level_1,_b_state_and_department_or_agency_b_level_2,_b_state_and_department_or_agency_b_level_3,_b_state_and_department_or_agency_b_hierarchy_depth,field_all_r_d_expenditures,field_source_of_funds_federal_government,field_source_of_funds_state_and_all_othersa
5214,r001,United States<sup>b</sup>,United States<sup>b</sup>,,,1,2444981212,607788664,1837192548
5214,r002,United States<sup>b</sup> -> Alabama,United States<sup>b</sup>,Alabama,,2,25695555,6774915,18920640
5214,r003,"United States<sup>b</sup> -> Alabama -> Choctawhatchee, Pea and Yellow Rivers Watershed Management Authority",United States<sup>b</sup>,Alabama,"Choctawhatchee, Pea and Yellow Rivers Watershed Management Authority",3,4000,0,4000
5214,r004,"United States<sup>b</sup> -> Alabama -> Commerce, Department of",United States<sup>b</sup>,Alabama,"Commerce, Department of",3,3000000,0,3000000
5214,r005,"United States<sup>b</sup> -> Alabama -> Conservation and Natural Resources, Department of; Wildlife and Freshwater Fisheries Division",United States<sup>b</sup>,Alabama,"Conservation and Natural Resources, Department of; Wildlife and Freshwater Fisheries Division",3,1930023,1691718,238305
5214,r006,"United States<sup>b</sup> -> Alabama -> Education, Department of",United States<sup>b</sup>,Alabama,"Education, Department of",3,9755650,16000,9739650
5214,r007,"United States<sup>b</sup> -> Alabama -> Forensic Sciences, Department of",United States<sup>b</sup>,Alabama,"Forensic Sciences, Department of",3,262993,0,262993
5214,r008,United States<sup>b</sup> -> Alabama -> Geological Survey,United States<sup>b</sup>,Alabama,Geological Survey,3,2470957,738855,1732102
5214,r009,"United States<sup>b</sup> -> Alabama -> Marine Environmental Science Consortium, Dauphin Island Sea Lab",United States<sup>b</sup>,Alabama,"Marine Environmental Science Consortium, Dauphin Island Sea Lab",3,1585939,1133914,452025
5214,r010,United States<sup>b</sup> -> Alabama -> Supercomputer Authority,United States<sup>b</sup>,Alabama,Supercomputer Authority,3,3028045,0,3028045
5214,r011,"United States<sup>b</sup> -> Alabama -> Transportation, Department of",United States<sup>b</sup>,Alabama,"Transportation, Department of",3,3657948,3194428,463520
5214,r012,United States<sup>b</sup> -> Alaska,United States<sup>b</sup>,Alaska,,2,15193507,6143917,9049590
5214,r013,"United States<sup>b</sup> -> Alaska -> Environmental Conservation, Department of ",United States<sup>b</sup>,Alaska,"Environmental Conservation, Department of ",3,474542,225313,249229
5214,r014,United States<sup>b</sup> -> Alaska -> Housing Finance Corporation,United States<sup>b</sup>,Alaska,Housing Finance Corporation,3,500000,0,500000
5214,r015,"United States<sup>b</sup> -> Alaska -> Natural Resources, Department of; Division of Geological and Geophysical Surveys",United States<sup>b</sup>,Alaska,"Natural Resources, Department of; Division of Geological and Geophysical Surveys",3,8878600,2100200,6778400
5214,r016,United States<sup>b</sup> -> Alaska -> Railroad Corporation,United States<sup>b</sup>,Alaska,Railroad Corporation,3,3824365,2605604,1218761
5214,r017,"United States<sup>b</sup> -> Alaska -> Transportation and Public Facilities, Department of",United States<sup>b</sup>,Alaska,"Transportation and Public Facilities, Department of",3,1516000,1212800,303200
5214,r018,United States<sup>b</sup> -> Arizona,United States<sup>b</sup>,Arizona,,2,16010502,3766942,12243560
5214,r019,"United States<sup>b</sup> -> Arizona -> Agriculture, Department of",United States<sup>b</sup>,Arizona,"Agriculture, Department of",3,1220812,1036529,184283
5214,r020,United States<sup>b</sup> -> Arizona -> Game and Fish Department,United States<sup>b</sup>,Arizona,Game and Fish Department,3,1361376,1257144,104232
5214,r021,"United States<sup>b</sup> -> Arizona -> Health Services, Department of",United States<sup>b</sup>,Arizona,"Health Services, Department of",3,11085857,0,11085857
5214,r022,"United States<sup>b</sup> -> Arizona -> Juvenile Corrections, Department of ",United States<sup>b</sup>,Arizona,"Juvenile Corrections, Department of ",3,559621,0,559621
5214,r023,"United States<sup>b</sup> -> Arizona -> Transportation, Department of",United States<sup>b</sup>,Arizona,"Transportation, Department of",3,1782836,1473269,309567
5214,r024,United States<sup>b</sup> -> Arkansas,United States<sup>b</sup>,Arkansas,,2,19921168,4966349,14954819
5214,r025,"United States<sup>b</sup> -> Arkansas -> Agriculture, Department of",United States<sup>b</sup>,Arkansas,"Agriculture, Department of",3,251460,0,251460
5214,r026,United States<sup>b</sup> -> Arkansas -> Beef Council,United States<sup>b</sup>,Arkansas,Beef Council,3,40223,0,40223
5214,r027,United States<sup>b</sup> -> Arkansas -> Corn and Grain Sorghum Board,United States<sup>b</sup>,Arkansas,Corn and Grain Sorghum Board,3,965000,0,965000
5214,r028,United States<sup>b</sup> -> Arkansas -> Economic Development Commission,United States<sup>b</sup>,Arkansas,Economic Development Commission,3,5446430,3449333,1997097
5214,r029,United States<sup>b</sup> -> Arkansas -> Game and Fish Commission,United States<sup>b</sup>,Arkansas,Game and Fish Commission,3,954281,946864,7417
5214,r030,United States<sup>b</sup> -> Arkansas -> Natural Heritage Commission,United States<sup>b</sup>,Arkansas,Natural Heritage Commission,3,274611,18065,256546
5214,r031,United States<sup>b</sup> -> Arkansas -> Rice Research and Promotion Board,United States<sup>b</sup>,Arkansas,Rice Research and Promotion Board,3,8623500,0,8623500
5214,r032,United States<sup>b</sup> -> Arkansas -> Soybean Promotion Board,United States<sup>b</sup>,Arkansas,Soybean Promotion Board,3,2625555,0,2625555
5214,r033,"United States<sup>b</sup> -> Arkansas -> Transportation, Department of",United States<sup>b</sup>,Arkansas,"Transportation, Department of",3,690108,552087,138021
5214,r034,United States<sup>b</sup> -> Arkansas -> Wheat Promotion Board,United States<sup>b</sup>,Arkansas,Wheat Promotion Board,3,50000,0,50000
5214,r035,United States<sup>b</sup> -> California,United States<sup>b</sup>,California,,2,533900597,22657670,511242927
5214,r036,United States<sup>b</sup> -> California -> Air Resources Board,United States<sup>b</sup>,California,Air Resources Board,3,16709642,0,16709642
5214,r037,United States<sup>b</sup> -> California -> Children and Families Commission (First 5 California),United States<sup>b</sup>,California,Children and Families Commission (First 5 California),3,3518680,0,3518680
5214,r038,"United States<sup>b</sup> -> California -> Conservation, Department of",United States<sup>b</sup>,California,"Conservation, Department of",3,1143000,190000,953000
5214,r039,"United States<sup>b</sup> -> California -> Corrections and Rehabilitation, Department of",United States<sup>b</sup>,California,"Corrections and Rehabilitation, Department of",3,1974791,0,1974791
5214,r040,United States<sup>b</sup> -> California -> Covered California,United States<sup>b</sup>,California,Covered California,3,3209181,0,3209181
5214,r041,United States<sup>b</sup> -> California -> Delta Stewardship Council,United States<sup>b</sup>,California,Delta Stewardship Council,3,5602379,1133461,4468918
5214,r042,United States<sup>b</sup> -> California -> Earthquake Authority,United States<sup>b</sup>,California,Earthquake Authority,3,2664000,0,2664000
5214,r043,United States<sup>b</sup> -> California -> Energy Commission,United States<sup>b</sup>,California,Energy Commission,3,219532543,0,219532543
5214,r044,"United States<sup>b</sup> -> California -> Environmental Health Hazard Assessment, Office of",United States<sup>b</sup>,California,"Environmental Health Hazard Assessment, Office of",3,19726954,0,19726954
5214,r045,"United States<sup>b</sup> -> California -> Food and Agriculture, Department of",United States<sup>b</sup>,California,"Food and Agriculture, Department of",3,4213376,298913,3914463
5214,r046,"United States<sup>b</sup> -> California -> Forestry and Fire Protection, Department of",United States<sup>b</sup>,California,"Forestry and Fire Protection, Department of",3,3500000,0,3500000
5214,r047,United States<sup>b</sup> -> California -> Horse Racing Board,United States<sup>b</sup>,California,Horse Racing Board,3,627442,0,627442
5214,r048,"United States<sup>b</sup> -> California -> Housing and Community Development, Department of",United States<sup>b</sup>,California,"Housing and Community Development, Department of",3,75000,0,75000
5214,r049,United States<sup>b</sup> -> California -> Institute for Regenerative Medicine,United States<sup>b</sup>,California,Institute for Regenerative Medicine,3,127546003,0,127546003
5214,r050,United States<sup>b</sup> -> California -> Mental Health Services Oversight and Accountability Commission,United States<sup>b</sup>,California,Mental Health Services Oversight and Accountability Commission,3,2500000,0,2500000
5214,r051,"United States<sup>b</sup> -> California -> Motor Vehicles, Department of",United States<sup>b</sup>,California,"Motor Vehicles, Department of",3,1401521,52964,1348557
5214,r052,"United States<sup>b</sup> -> California -> Pesticide Regulation, Department of ",United States<sup>b</sup>,California,"Pesticide Regulation, Department of ",3,14088416,109485,13978931
5214,r053,"United States<sup>b</sup> -> California -> Public Health, Department of",United States<sup>b</sup>,California,"Public Health, Department of",3,3370497,169,3370328
5214,r054,"United States<sup>b</sup> -> California -> Public Utilities Commission, Executive Division",United States<sup>b</sup>,California,"Public Utilities Commission, Executive Division",3,37000000,0,37000000
5214,r055,"United States<sup>b</sup> -> California -> Rehabilitation, Department of ",United States<sup>b</sup>,California,"Rehabilitation, Department of ",3,2814595,2814595,0
5214,r056,United States<sup>b</sup> -> California -> State Coastal Conservancy,United States<sup>b</sup>,California,State Coastal Conservancy,3,1620693,119114,1501579
5214,r057,United States<sup>b</sup> -> California -> State Water Resources Control Board,United States<sup>b</sup>,California,State Water Resources Control Board,3,17957684,1546120,16411564
5214,r058,"United States<sup>b</sup> -> California -> Transportation, Department of",United States<sup>b</sup>,California,"Transportation, Department of",3,41248806,16347019,24901787
5214,r059,"United States<sup>b</sup> -> California -> Water Resources, Department of",United States<sup>b</sup>,California,"Water Resources, Department of",3,1855394,45830,1809564
5214,r060,United States<sup>b</sup> -> Colorado,United States<sup>b</sup>,Colorado,,2,34365638,6659704,27705934
5214,r061,"United States<sup>b</sup> -> Colorado -> Agriculture, Department of",United States<sup>b</sup>,Colorado,"Agriculture, Department of",3,635148,625148,10000
5214,r062,"United States<sup>b</sup> -> Colorado -> Economic Development and International Trade, Office of",United States<sup>b</sup>,Colorado,"Economic Development and International Trade, Office of",3,15456483,0,15456483
5214,r063,"United States<sup>b</sup> -> Colorado -> Higher Education Competitive, Research Authority",United States<sup>b</sup>,Colorado,"Higher Education Competitive, Research Authority",3,2455224,0,2455224
5214,r064,"United States<sup>b</sup> -> Colorado -> Higher Education, Department of ",United States<sup>b</sup>,Colorado,"Higher Education, Department of ",3,124839,124839,0
5214,r065,"United States<sup>b</sup> -> Colorado -> Natural Resources, Department of",United States<sup>b</sup>,Colorado,"Natural Resources, Department of",3,8002949,2708309,5294640
5214,r066,"United States<sup>b</sup> -> Colorado -> Public Health and Environment, Department of",United States<sup>b</sup>,Colorado,"Public Health and Environment, Department of",3,3808558,311904,3496654
5214,r067,"United States<sup>b</sup> -> Colorado -> Public Safety, Department of",United States<sup>b</sup>,Colorado,"Public Safety, Department of",3,826494,55871,770623
5214,r068,"United States<sup>b</sup> -> Colorado -> Transportation, Department of",United States<sup>b</sup>,Colorado,"Transportation, Department of",3,2833633,2833633,0
5214,r069,United States<sup>b</sup> -> Colorado -> Wine Industry Development Board,United States<sup>b</sup>,Colorado,Wine Industry Development Board,3,222310,0,222310
5214,r070,United States<sup>b</sup> -> Connecticut,United States<sup>b</sup>,Connecticut,,2,58810853,15873807,42937046
5214,r071,United States<sup>b</sup> -> Connecticut -> Agricultural Experiment Station,United States<sup>b</sup>,Connecticut,Agricultural Experiment Station,3,12445226,5337429,7107797
5214,r072,"United States<sup>b</sup> -> Connecticut -> Children and Families, Department of",United States<sup>b</sup>,Connecticut,"Children and Families, Department of",3,604461,115524,488937
5214,r073,"United States<sup>b</sup> -> Connecticut -> Education, Department of",United States<sup>b</sup>,Connecticut,"Education, Department of",3,429097,429097,0
5214,r074,"United States<sup>b</sup> -> Connecticut -> Energy and Environmental Protection, Department of",United States<sup>b</sup>,Connecticut,"Energy and Environmental Protection, Department of",3,7498136,5404300,2093836
5214,r075,United States<sup>b</sup> -> Connecticut -> Innovation Inc.,United States<sup>b</sup>,Connecticut,Innovation Inc.,3,27245173,0,27245173
5214,r076,"United States<sup>b</sup> -> Connecticut -> Mental Health and Addiction Services, Department of",United States<sup>b</sup>,Connecticut,"Mental Health and Addiction Services, Department of",3,6310349,626074,5684275
5214,r077,"United States<sup>b</sup> -> Connecticut -> Public Health, Department of",United States<sup>b</sup>,Connecticut,"Public Health, Department of",3,27000,27000,0
5214,r078,"United States<sup>b</sup> -> Connecticut -> Social Services, Department of",United States<sup>b</sup>,Connecticut,"Social Services, Department of",3,1516916,1516916,0
5214,r079,"United States<sup>b</sup> -> Connecticut -> Transportation, Department of",United States<sup>b</sup>,Connecticut,"Transportation, Department of",3,2734495,2417467,317028
5214,r080,United States<sup>b</sup> -> Delaware,United States<sup>b</sup>,Delaware,,2,3598156,1476864,2121292
5214,r081,United States<sup>b</sup> -> Delaware -> Geological Survey,United States<sup>b</sup>,Delaware,Geological Survey,3,2183965,405384,1778581
5214,r082,"United States<sup>b</sup> -> Delaware -> Natural Resources and Environmental Control, Department of",United States<sup>b</sup>,Delaware,"Natural Resources and Environmental Control, Department of",3,159000,109700,49300
5214,r083,United States<sup>b</sup> -> Delaware -> Sustainable Energy Utility,United States<sup>b</sup>,Delaware,Sustainable Energy Utility,3,20800,0,20800
5214,r084,"United States<sup>b</sup> -> Delaware -> Transportation, Department of",United States<sup>b</sup>,Delaware,"Transportation, Department of",3,1234391,961780,272611
5214,r085,United States<sup>b</sup> -> District of Columbia,United States<sup>b</sup>,District of Columbia,,2,5860668,2560026,3300642
5214,r086,"United States<sup>b</sup> -> District of Columbia -> Energy and Environment, Department of",United States<sup>b</sup>,District of Columbia,"Energy and Environment, Department of",3,1550000,471000,1079000
5214,r087,"United States<sup>b</sup> -> District of Columbia -> Forensic Sciences, Department of",United States<sup>b</sup>,District of Columbia,"Forensic Sciences, Department of",3,114283,30000,84283
5214,r088,"United States<sup>b</sup> -> District of Columbia -> Health, Department of",United States<sup>b</sup>,District of Columbia,"Health, Department of",3,1957090,1867590,89500
5214,r089,"United States<sup>b</sup> -> District of Columbia -> Transportation, Department of",United States<sup>b</sup>,District of Columbia,"Transportation, Department of",3,239295,191436,47859
5214,r090,United States<sup>b</sup> -> District of Columbia -> Water and Sewer Authority,United States<sup>b</sup>,District of Columbia,Water and Sewer Authority,3,2000000,0,2000000
5214,r091,United States<sup>b</sup> -> Florida,United States<sup>b</sup>,Florida,,2,184600202,30382990,154217212
5214,r092,"United States<sup>b</sup> -> Florida -> Agriculture and Consumer Services, Department of",United States<sup>b</sup>,Florida,"Agriculture and Consumer Services, Department of",3,22450768,10465613,11985155
5214,r093,"United States<sup>b</sup> -> Florida -> Business and Professional Regulation, Department of",United States<sup>b</sup>,Florida,"Business and Professional Regulation, Department of",3,88406,0,88406
5214,r094,"United States<sup>b</sup> -> Florida -> Citrus, Department of",United States<sup>b</sup>,Florida,"Citrus, Department of",3,1127588,0,1127588
5214,r095,"United States<sup>b</sup> -> Florida -> Environmental Protection, Department of",United States<sup>b</sup>,Florida,"Environmental Protection, Department of",3,217759,66669,151090
5214,r096,United States<sup>b</sup> -> Florida -> Fish and Wildlife Conservation Commission,United States<sup>b</sup>,Florida,Fish and Wildlife Conservation Commission,3,56278906,12823710,43455196
5214,r097,"United States<sup>b</sup> -> Florida -> Health, Department of",United States<sup>b</sup>,Florida,"Health, Department of",3,91114600,0,91114600
5214,r098,United States<sup>b</sup> -> Florida -> Space Florida,United States<sup>b</sup>,Florida,Space Florida,3,1299010,0,1299010
5214,r099,"United States<sup>b</sup> -> Florida -> Transportation, Department of",United States<sup>b</sup>,Florida,"Transportation, Department of",3,12023165,7026998,4996167
5214,r100,United States<sup>b</sup> -> Georgia,United States<sup>b</sup>,Georgia,,2,15877238,14101354,1775884
5214,r101,"United States<sup>b</sup> -> Georgia -> Natural Resources, Department of",United States<sup>b</sup>,Georgia,"Natural Resources, Department of",3,997526,672871,324655
5214,r102,United States<sup>b</sup> -> Georgia -> Seed Development Commission,United States<sup>b</sup>,Georgia,Seed Development Commission,3,255642,0,255642
5214,r103,United States<sup>b</sup> -> Georgia -> Southern States Energy Board,United States<sup>b</sup>,Georgia,Southern States Energy Board,3,8092378,7893986,198392
5214,r104,"United States<sup>b</sup> -> Georgia -> Transportation, Department of",United States<sup>b</sup>,Georgia,"Transportation, Department of",3,6531692,5534497,997195
5214,r105,United States<sup>b</sup> -> Hawaii,United States<sup>b</sup>,Hawaii,,2,11122545,7330911,3791634
5214,r106,"United States<sup>b</sup> -> Hawaii -> Agriculture, Department of",United States<sup>b</sup>,Hawaii,"Agriculture, Department of",3,702000,632000,70000
5214,r107,"United States<sup>b</sup> -> Hawaii -> Business, Economic Development, and Tourism, Department of",United States<sup>b</sup>,Hawaii,"Business, Economic Development, and Tourism, Department of",3,7297767,5491637,1806130
5214,r108,"United States<sup>b</sup> -> Hawaii -> Land and Natural Resources, Department of",United States<sup>b</sup>,Hawaii,"Land and Natural Resources, Department of",3,385278,68774,316504
5214,r109,United States<sup>b</sup> -> Hawaii -> Natural Energy Laboratory,United States<sup>b</sup>,Hawaii,Natural Energy Laboratory,3,2250000,900000,1350000
5214,r110,"United States<sup>b</sup> -> Hawaii -> Transportation, Department of",United States<sup>b</sup>,Hawaii,"Transportation, Department of",3,487500,238500,249000
5214,r111,United States<sup>b</sup> -> Idaho,United States<sup>b</sup>,Idaho,,2,21882976,12620448,9262528
5214,r112,"United States<sup>b</sup> -> Idaho -> Agriculture, Department of",United States<sup>b</sup>,Idaho,"Agriculture, Department of",3,900539,900539,0
5214,r113,United States<sup>b</sup> -> Idaho -> Alfalfa and Clover Seed Commission,United States<sup>b</sup>,Idaho,Alfalfa and Clover Seed Commission,3,1500,0,1500
5214,r114,United States<sup>b</sup> -> Idaho -> Barley Commission,United States<sup>b</sup>,Idaho,Barley Commission,3,238859,0,238859
5214,r115,United States<sup>b</sup> -> Idaho -> Bean Commission,United States<sup>b</sup>,Idaho,Bean Commission,3,28220,0,28220
5214,r116,United States<sup>b</sup> -> Idaho -> Beef Council,United States<sup>b</sup>,Idaho,Beef Council,3,88187,0,88187
5214,r117,"United States<sup>b</sup> -> Idaho -> Commerce, Department of ",United States<sup>b</sup>,Idaho,"Commerce, Department of ",3,953711,0,953711
5214,r118,United States<sup>b</sup> -> Idaho -> Dairy West,United States<sup>b</sup>,Idaho,Dairy West,3,2900000,0,2900000
5214,r119,"United States<sup>b</sup> -> Idaho -> Environmental Quality, Department of",United States<sup>b</sup>,Idaho,"Environmental Quality, Department of",3,450000,0,450000
5214,r120,"United States<sup>b</sup> -> Idaho -> Fish and Game, Department of",United States<sup>b</sup>,Idaho,"Fish and Game, Department of",3,10381981,8783225,1598756
5214,r121,United States<sup>b</sup> -> Idaho -> Honey Commission,United States<sup>b</sup>,Idaho,Honey Commission,3,1500,0,1500
5214,r122,United States<sup>b</sup> -> Idaho -> Oilseed Commission,United States<sup>b</sup>,Idaho,Oilseed Commission,3,62000,0,62000
5214,r123,United States<sup>b</sup> -> Idaho -> Pea and Lentil Commission,United States<sup>b</sup>,Idaho,Pea and Lentil Commission,3,73418,0,73418
5214,r124,United States<sup>b</sup> -> Idaho -> Potato Commission,United States<sup>b</sup>,Idaho,Potato Commission,3,1596042,95067,1500975
5214,r125,United States<sup>b</sup> -> Idaho -> Transportation Department,United States<sup>b</sup>,Idaho,Transportation Department,3,3069711,2841617,228094
5214,r126,United States<sup>b</sup> -> Idaho -> Wheat Commission,United States<sup>b</sup>,Idaho,Wheat Commission,3,1137308,0,1137308
5214,r127,United States<sup>b</sup> -> Illinois,United States<sup>b</sup>,Illinois,,2,16055917,7641755,8414162
5214,r128,"United States<sup>b</sup> -> Illinois -> Children and Family Services, Department of",United States<sup>b</sup>,Illinois,"Children and Family Services, Department of",3,2559932,0,2559932
5214,r129,"United States<sup>b</sup> -> Illinois -> Human Services, Department of",United States<sup>b</sup>,Illinois,"Human Services, Department of",3,244978,244978,0
5214,r130,United States<sup>b</sup> -> Illinois -> Nutrient Research and Education,United States<sup>b</sup>,Illinois,Nutrient Research and Education,3,3140385,0,3140385
5214,r131,"United States<sup>b</sup> -> Illinois -> Public Health, Department of",United States<sup>b</sup>,Illinois,"Public Health, Department of",3,399924,0,399924
5214,r132,"United States<sup>b</sup> -> Illinois -> Transportation, Department of",United States<sup>b</sup>,Illinois,"Transportation, Department of",3,9710698,7396777,2313921
5214,r133,United States<sup>b</sup> -> Indiana,United States<sup>b</sup>,Indiana,,2,9591408,7126764,2464644
5214,r134,United States<sup>b</sup> -> Indiana -> Economic Development Corporation,United States<sup>b</sup>,Indiana,Economic Development Corporation,3,595000,0,595000
5214,r135,"United States<sup>b</sup> -> Indiana -> Environmental Management, Department of",United States<sup>b</sup>,Indiana,"Environmental Management, Department of",3,56764,56764,0
5214,r136,"United States<sup>b</sup> -> Indiana -> Natural Resources, Department of",United States<sup>b</sup>,Indiana,"Natural Resources, Department of",3,100000,0,100000
5214,r137,United States<sup>b</sup> -> Indiana -> St. Joseph River Basin Commission,United States<sup>b</sup>,Indiana,St. Joseph River Basin Commission,3,105000,0,105000
5214,r138,"United States<sup>b</sup> -> Indiana -> Transportation, Department of",United States<sup>b</sup>,Indiana,"Transportation, Department of",3,8734644,7070000,1664644
5214,r139,United States<sup>b</sup> -> Iowa,United States<sup>b</sup>,Iowa,,2,12348062,7734114,4613948
5214,r140,United States<sup>b</sup> -> Iowa -> Beef Industry Council,United States<sup>b</sup>,Iowa,Beef Industry Council,3,60000,0,60000
5214,r141,United States<sup>b</sup> -> Iowa -> Corrections,United States<sup>b</sup>,Iowa,Corrections,3,470931,0,470931
5214,r142,"United States<sup>b</sup> -> Iowa -> Human Rights, Criminal and Juvenile Justice Planning, Division of, Department of",United States<sup>b</sup>,Iowa,"Human Rights, Criminal and Juvenile Justice Planning, Division of, Department of",3,417493,220463,197030
5214,r143,"United States<sup>b</sup> -> Iowa -> Natural Resources, Department of",United States<sup>b</sup>,Iowa,"Natural Resources, Department of",3,4170756,2076078,2094678
5214,r144,"United States<sup>b</sup> -> Iowa -> Transportation, Department of",United States<sup>b</sup>,Iowa,"Transportation, Department of",3,7228882,5437573,1791309
5214,r145,United States<sup>b</sup> -> Kansas,United States<sup>b</sup>,Kansas,,2,13152904,6612890,6540014
5214,r146,United States<sup>b</sup> -> Kansas -> Corn Commission,United States<sup>b</sup>,Kansas,Corn Commission,3,871765,0,871765
5214,r147,United States<sup>b</sup> -> Kansas -> Grain Sorghum Commission,United States<sup>b</sup>,Kansas,Grain Sorghum Commission,3,445300,0,445300
5214,r148,United States<sup>b</sup> -> Kansas -> Soybean Commission,United States<sup>b</sup>,Kansas,Soybean Commission,3,1200000,0,1200000
5214,r149,United States<sup>b</sup> -> Kansas -> State Board of Regents,United States<sup>b</sup>,Kansas,State Board of Regents,3,998756,0,998756
5214,r150,United States<sup>b</sup> -> Kansas -> Sunflower Commission,United States<sup>b</sup>,Kansas,Sunflower Commission,3,20000,0,20000
5214,r151,"United States<sup>b</sup> -> Kansas -> Transportation, Department of",United States<sup>b</sup>,Kansas,"Transportation, Department of",3,3637912,2452147,1185765
5214,r152,United States<sup>b</sup> -> Kansas -> Water Office,United States<sup>b</sup>,Kansas,Water Office,3,429361,57002,372359
5214,r153,United States<sup>b</sup> -> Kansas -> Wheat Commission,United States<sup>b</sup>,Kansas,Wheat Commission,3,1138289,0,1138289
5214,r154,"United States<sup>b</sup> -> Kansas -> Wildlife, Parks, and Tourism, Department of",United States<sup>b</sup>,Kansas,"Wildlife, Parks, and Tourism, Department of",3,4411521,4103741,307780
5214,r155,United States<sup>b</sup> -> Kentucky,United States<sup>b</sup>,Kentucky,,2,26782125,6273543,20508582
5214,r156,"United States<sup>b</sup> -> Kentucky -> Behavioral Health, Developmental and Intellectual Disabilities",United States<sup>b</sup>,Kentucky,"Behavioral Health, Developmental and Intellectual Disabilities",3,67500,0,67500
5214,r157,"United States<sup>b</sup> -> Kentucky -> Economic Development, Cabinet for",United States<sup>b</sup>,Kentucky,"Economic Development, Cabinet for",3,3051000,0,3051000
5214,r158,"United States<sup>b</sup> -> Kentucky -> Fish and Wildlife Resources, Department of ",United States<sup>b</sup>,Kentucky,"Fish and Wildlife Resources, Department of ",3,2008546,1271959,736587
5214,r159,United States<sup>b</sup> -> Kentucky -> Horse Racing Commission,United States<sup>b</sup>,Kentucky,Horse Racing Commission,3,430748,0,430748
5214,r160,"United States<sup>b</sup> -> Kentucky -> Nature Preserves, Office of ",United States<sup>b</sup>,Kentucky,"Nature Preserves, Office of ",3,34200,0,34200
5214,r161,"United States<sup>b</sup> -> Kentucky -> Postsecondary Education, Council on",United States<sup>b</sup>,Kentucky,"Postsecondary Education, Council on",3,9939022,0,9939022
5214,r162,"United States<sup>b</sup> -> Kentucky -> Public Health, Department for ",United States<sup>b</sup>,Kentucky,"Public Health, Department for ",3,3336309,0,3336309
5214,r163,United States<sup>b</sup> -> Kentucky -> Public Service Commission,United States<sup>b</sup>,Kentucky,Public Service Commission,3,21000,0,21000
5214,r164,United States<sup>b</sup> -> Kentucky -> Soybean Promotion Board,United States<sup>b</sup>,Kentucky,Soybean Promotion Board,3,658864,0,658864
5214,r165,United States<sup>b</sup> -> Kentucky -> Transportation Cabinet,United States<sup>b</sup>,Kentucky,Transportation Cabinet,3,7234936,5001584,2233352
5214,r166,United States<sup>b</sup> -> Louisiana,United States<sup>b</sup>,Louisiana,,2,32360516,19451587,12908929
5214,r167,United States<sup>b</sup> -> Louisiana -> Board of Regents,United States<sup>b</sup>,Louisiana,Board of Regents,3,12728300,6291305,6436995
5214,r168,United States<sup>b</sup> -> Louisiana -> Coastal Protection and Restoration Authority,United States<sup>b</sup>,Louisiana,Coastal Protection and Restoration Authority,3,3436344,642156,2794188
5214,r169,"United States<sup>b</sup> -> Louisiana -> Education, Department of",United States<sup>b</sup>,Louisiana,"Education, Department of",3,394664,199912,194752
5214,r170,"United States<sup>b</sup> -> Louisiana -> Transportation and Development, Department of ",United States<sup>b</sup>,Louisiana,"Transportation and Development, Department of ",3,9200000,7360000,1840000
5214,r171,"United States<sup>b</sup> -> Louisiana -> Wildlife and Fisheries, Department of",United States<sup>b</sup>,Louisiana,"Wildlife and Fisheries, Department of",3,6601208,4958214,1642994
5214,r172,United States<sup>b</sup> -> Maine,United States<sup>b</sup>,Maine,,2,29035990,4162595,24873395
5214,r173,"United States<sup>b</sup> -> Maine -> Agriculture, Conservation and Forestry, Department of ",United States<sup>b</sup>,Maine,"Agriculture, Conservation and Forestry, Department of ",3,1511473,648246,863227
5214,r174,"United States<sup>b</sup> -> Maine -> Inland Fisheries and Wildlife, Department of",United States<sup>b</sup>,Maine,"Inland Fisheries and Wildlife, Department of",3,1080841,847899,232942
5214,r175,"United States<sup>b</sup> -> Maine -> Marine Resources, Department of",United States<sup>b</sup>,Maine,"Marine Resources, Department of",3,2458575,1962450,496125
5214,r176,United States<sup>b</sup> -> Maine -> Technology Institute,United States<sup>b</sup>,Maine,Technology Institute,3,23161101,0,23161101
5214,r177,"United States<sup>b</sup> -> Maine -> Transportation, Department of ",United States<sup>b</sup>,Maine,"Transportation, Department of ",3,824000,704000,120000
5214,r178,United States<sup>b</sup> -> Maryland,United States<sup>b</sup>,Maryland,,2,33407022,4016621,29390401
5214,r179,"United States<sup>b</sup> -> Maryland -> Education, Department of",United States<sup>b</sup>,Maryland,"Education, Department of",3,1160456,1160456,0
5214,r180,United States<sup>b</sup> -> Maryland -> Energy Administration,United States<sup>b</sup>,Maryland,Energy Administration,3,1026832,0,1026832
5214,r181,"United States<sup>b</sup> -> Maryland -> Health and Mental Hygiene, Department of",United States<sup>b</sup>,Maryland,"Health and Mental Hygiene, Department of",3,15000000,0,15000000
5214,r182,"United States<sup>b</sup> -> Maryland -> Natural Resources, Department of",United States<sup>b</sup>,Maryland,"Natural Resources, Department of",3,607906,12000,595906
5214,r183,United States<sup>b</sup> -> Maryland -> Technology Development Corporation,United States<sup>b</sup>,Maryland,Technology Development Corporation,3,10964344,0,10964344
5214,r184,"United States<sup>b</sup> -> Maryland -> Transportation, Department of",United States<sup>b</sup>,Maryland,"Transportation, Department of",3,4647484,2844165,1803319
5214,r185,United States<sup>b</sup> -> Massachusetts,United States<sup>b</sup>,Massachusetts,,2,31700411,11397894,20302517
5214,r186,United States<sup>b</sup> -> Massachusetts -> Clean Energy Technology Center,United States<sup>b</sup>,Massachusetts,Clean Energy Technology Center,3,4008011,0,4008011
5214,r187,"United States<sup>b</sup> -> Massachusetts -> Environmental Protection, Department of ",United States<sup>b</sup>,Massachusetts,"Environmental Protection, Department of ",3,309872,22507,287365
5214,r188,"United States<sup>b</sup> -> Massachusetts -> Fish and Game, Department of ",United States<sup>b</sup>,Massachusetts,"Fish and Game, Department of ",3,9493000,6340000,3153000
5214,r189,United States<sup>b</sup> -> Massachusetts -> Gaming Commission,United States<sup>b</sup>,Massachusetts,Gaming Commission,3,2670000,0,2670000
5214,r190,United States<sup>b</sup> -> Massachusetts -> Life Sciences Center,United States<sup>b</sup>,Massachusetts,Life Sciences Center,3,1030299,0,1030299
5214,r191,United States<sup>b</sup> -> Massachusetts -> Massventures,United States<sup>b</sup>,Massachusetts,Massventures,3,3100000,0,3100000
5214,r192,"United States<sup>b</sup> -> Massachusetts -> Mental Health, Department of",United States<sup>b</sup>,Massachusetts,"Mental Health, Department of",3,1800000,0,1800000
5214,r193,"United States<sup>b</sup> -> Massachusetts -> Public Health, Department of ",United States<sup>b</sup>,Massachusetts,"Public Health, Department of ",3,1849229,1585387,263842
5214,r194,United States<sup>b</sup> -> Massachusetts -> Technology Park Corporation ,United States<sup>b</sup>,Massachusetts,Technology Park Corporation ,3,3175000,0,3175000
5214,r195,"United States<sup>b</sup> -> Massachusetts -> Transportation, Department of",United States<sup>b</sup>,Massachusetts,"Transportation, Department of",3,4065000,3450000,615000
5214,r196,United States<sup>b</sup> -> Massachusetts -> Water Resources Authority,United States<sup>b</sup>,Massachusetts,Water Resources Authority,3,200000,0,200000
5214,r197,United States<sup>b</sup> -> Michigan,United States<sup>b</sup>,Michigan,,2,11191816,7184297,4007519
5214,r198,"United States<sup>b</sup> -> Michigan -> Agriculture and Rural Development, Department of",United States<sup>b</sup>,Michigan,"Agriculture and Rural Development, Department of",3,3316092,1049314,2266778
5214,r199,"United States<sup>b</sup> -> Michigan -> Environmental, Great Lakes and Energy, Department of",United States<sup>b</sup>,Michigan,"Environmental, Great Lakes and Energy, Department of",3,1265405,432610,832795
5214,r200,"United States<sup>b</sup> -> Michigan -> Transportation, Department of",United States<sup>b</sup>,Michigan,"Transportation, Department of",3,6610319,5702373,907946
5214,r201,United States<sup>b</sup> -> Minnesota,United States<sup>b</sup>,Minnesota,,2,20511698,6272311,14239387
5214,r202,"United States<sup>b</sup> -> Minnesota -> Agriculture, Department of",United States<sup>b</sup>,Minnesota,"Agriculture, Department of",3,6203140,651359,5551781
5214,r203,United States<sup>b</sup> -> Minnesota -> Forest Resources Council,United States<sup>b</sup>,Minnesota,Forest Resources Council,3,150000,0,150000
5214,r204,"United States<sup>b</sup> -> Minnesota -> Natural Resources, Department of",United States<sup>b</sup>,Minnesota,"Natural Resources, Department of",3,1941631,1153270,788361
5214,r205,United States<sup>b</sup> -> Minnesota -> Pollution Control Agency,United States<sup>b</sup>,Minnesota,Pollution Control Agency,3,25981,0,25981
5214,r206,"United States<sup>b</sup> -> Minnesota -> Transportation, Department of",United States<sup>b</sup>,Minnesota,"Transportation, Department of",3,12190946,4467682,7723264
5214,r207,United States<sup>b</sup> -> Mississippi,United States<sup>b</sup>,Mississippi,,2,10268396,8768392,1500004
5214,r208,"United States<sup>b</sup> -> Mississippi -> Agriculture and Commerce, Department of ",United States<sup>b</sup>,Mississippi,"Agriculture and Commerce, Department of ",3,180501,180501,0
5214,r209,"United States<sup>b</sup> -> Mississippi -> Environmental Quality, Department of",United States<sup>b</sup>,Mississippi,"Environmental Quality, Department of",3,1804582,1804582,0
5214,r210,United States<sup>b</sup> -> Mississippi -> Gulf States Marine Fisheries Commission,United States<sup>b</sup>,Mississippi,Gulf States Marine Fisheries Commission,3,1100424,1100424,0
5214,r211,"United States<sup>b</sup> -> Mississippi -> Marine Resources, Department of",United States<sup>b</sup>,Mississippi,"Marine Resources, Department of",3,1060182,468328,591854
5214,r212,"United States<sup>b</sup> -> Mississippi -> Transportation, Department of",United States<sup>b</sup>,Mississippi,"Transportation, Department of",3,4417666,3944327,473339
5214,r213,"United States<sup>b</sup> -> Mississippi -> Wildlife, Fisheries, and Parks, Department of ",United States<sup>b</sup>,Mississippi,"Wildlife, Fisheries, and Parks, Department of ",3,1705041,1270230,434811
5214,r214,United States<sup>b</sup> -> Missouri,United States<sup>b</sup>,Missouri,,2,14826364,5750412,9075952
5214,r215,"United States<sup>b</sup> -> Missouri -> Agriculture, Department of",United States<sup>b</sup>,Missouri,"Agriculture, Department of",3,95763,95763,0
5214,r216,"United States<sup>b</sup> -> Missouri -> Conservation, Department of",United States<sup>b</sup>,Missouri,"Conservation, Department of",3,10860153,3939815,6920338
5214,r217,"United States<sup>b</sup> -> Missouri -> Health and Senior Services, Department of",United States<sup>b</sup>,Missouri,"Health and Senior Services, Department of",3,29761,11322,18439
5214,r218,"United States<sup>b</sup> -> Missouri -> Mental Health, Department of",United States<sup>b</sup>,Missouri,"Mental Health, Department of",3,121250,0,121250
5214,r219,"United States<sup>b</sup> -> Missouri -> Natural Resources, Department of",United States<sup>b</sup>,Missouri,"Natural Resources, Department of",3,743537,202023,541514
5214,r220,United States<sup>b</sup> -> Missouri -> Technology Corporation,United States<sup>b</sup>,Missouri,Technology Corporation,3,582296,200000,382296
5214,r221,"United States<sup>b</sup> -> Missouri -> Transportation, Department of",United States<sup>b</sup>,Missouri,"Transportation, Department of",3,1557401,1301489,255912
5214,r222,United States<sup>b</sup> -> Missouri -> Wine and Grape Board,United States<sup>b</sup>,Missouri,Wine and Grape Board,3,836203,0,836203
5214,r223,United States<sup>b</sup> -> Montana,United States<sup>b</sup>,Montana,,2,13131022,6777890,6353132
5214,r224,"United States<sup>b</sup> -> Montana -> Agriculture, Department of",United States<sup>b</sup>,Montana,"Agriculture, Department of",3,3566938,1064629,2502309
5214,r225,"United States<sup>b</sup> -> Montana -> Environmental Quality, Department of",United States<sup>b</sup>,Montana,"Environmental Quality, Department of",3,92296,40921,51375
5214,r226,"United States<sup>b</sup> -> Montana -> Fish, Wildlife and Parks, Department of",United States<sup>b</sup>,Montana,"Fish, Wildlife and Parks, Department of",3,7640799,4146662,3494137
5214,r227,"United States<sup>b</sup> -> Montana -> Natural Resources and Conservation, Department of",United States<sup>b</sup>,Montana,"Natural Resources and Conservation, Department of",3,20000,0,20000
5214,r228,"United States<sup>b</sup> -> Montana -> Transportation, Department of",United States<sup>b</sup>,Montana,"Transportation, Department of",3,1810989,1525678,285311
5214,r229,United States<sup>b</sup> -> Nebraska,United States<sup>b</sup>,Nebraska,,2,32423818,6818177,25605641
5214,r230,"United States<sup>b</sup> -> Nebraska -> Agriculture, Department of",United States<sup>b</sup>,Nebraska,"Agriculture, Department of",3,645372,490612,154760
5214,r231,United States<sup>b</sup> -> Nebraska -> Corn Board,United States<sup>b</sup>,Nebraska,Corn Board,3,803068,0,803068
5214,r232,United States<sup>b</sup> -> Nebraska -> Dairy Industry Development Board,United States<sup>b</sup>,Nebraska,Dairy Industry Development Board,3,87654,0,87654
5214,r233,United States<sup>b</sup> -> Nebraska -> Dry Bean Commission,United States<sup>b</sup>,Nebraska,Dry Bean Commission,3,290954,0,290954
5214,r234,"United States<sup>b</sup> -> Nebraska -> Economic Development, Department of",United States<sup>b</sup>,Nebraska,"Economic Development, Department of",3,2184835,0,2184835
5214,r235,United States<sup>b</sup> -> Nebraska -> Game and Parks Commission,United States<sup>b</sup>,Nebraska,Game and Parks Commission,3,5798854,4798206,1000648
5214,r236,United States<sup>b</sup> -> Nebraska -> Grain Sorghum Board,United States<sup>b</sup>,Nebraska,Grain Sorghum Board,3,3672,1836,1836
5214,r237,"United States<sup>b</sup> -> Nebraska -> Health and Human Services, Department of",United States<sup>b</sup>,Nebraska,"Health and Human Services, Department of",3,19453501,0,19453501
5214,r238,"United States<sup>b</sup> -> Nebraska -> Natural Resources, Department of",United States<sup>b</sup>,Nebraska,"Natural Resources, Department of",3,958089,0,958089
5214,r239,"United States<sup>b</sup> -> Nebraska -> Transportation, Department of",United States<sup>b</sup>,Nebraska,"Transportation, Department of",3,1909404,1527523,381881
5214,r240,United States<sup>b</sup> -> Nebraska -> Wheat Board,United States<sup>b</sup>,Nebraska,Wheat Board,3,288415,0,288415
5214,r241,United States<sup>b</sup> -> Nevada,United States<sup>b</sup>,Nevada,,2,4764898,1606707,3158191
5214,r242,"United States<sup>b</sup> -> Nevada -> Agriculture, Department of",United States<sup>b</sup>,Nevada,"Agriculture, Department of",3,188146,128146,60000
5214,r243,"United States<sup>b</sup> -> Nevada -> Economic Development, Governor's office of",United States<sup>b</sup>,Nevada,"Economic Development, Governor's office of",3,3055388,98351,2957037
5214,r244,"United States<sup>b</sup> -> Nevada -> Transportation, Department of",United States<sup>b</sup>,Nevada,"Transportation, Department of",3,1521364,1380210,141154
5214,r245,United States<sup>b</sup> -> New Hampshire,United States<sup>b</sup>,New Hampshire,,2,8221518,639820,7581698
5214,r246,"United States<sup>b</sup> -> New Hampshire -> Agriculture, Markets and Food, Department of",United States<sup>b</sup>,New Hampshire,"Agriculture, Markets and Food, Department of",3,146743,0,146743
5214,r247,"United States<sup>b</sup> -> New Hampshire -> Business and Economic Affairs, Department of",United States<sup>b</sup>,New Hampshire,"Business and Economic Affairs, Department of",3,7275000,0,7275000
5214,r248,"United States<sup>b</sup> -> New Hampshire -> Transportation, Department of",United States<sup>b</sup>,New Hampshire,"Transportation, Department of",3,799775,639820,159955
5214,r249,United States<sup>b</sup> -> New Jersey,United States<sup>b</sup>,New Jersey,,2,23754925,3299908,20455017
5214,r250,"United States<sup>b</sup> -> New Jersey -> Children and Families, Department of",United States<sup>b</sup>,New Jersey,"Children and Families, Department of",3,237423,29406,208017
5214,r251,"United States<sup>b</sup> -> New Jersey -> Corrections, Department of",United States<sup>b</sup>,New Jersey,"Corrections, Department of",3,305895,0,305895
5214,r252,"United States<sup>b</sup> -> New Jersey -> Environmental Protection, Department of",United States<sup>b</sup>,New Jersey,"Environmental Protection, Department of",3,2608000,705000,1903000
5214,r253,"United States<sup>b</sup> -> New Jersey -> Health, Department of",United States<sup>b</sup>,New Jersey,"Health, Department of",3,940186,0,940186
5214,r254,United States<sup>b</sup> -> New Jersey -> Pinelands Commission,United States<sup>b</sup>,New Jersey,Pinelands Commission,3,537794,537794,0
5214,r255,"United States<sup>b</sup> -> New Jersey -> Research Initiatives, Office of",United States<sup>b</sup>,New Jersey,"Research Initiatives, Office of",3,13000000,0,13000000
5214,r256,"United States<sup>b</sup> -> New Jersey -> Secretary of Higher Education, Office of",United States<sup>b</sup>,New Jersey,"Secretary of Higher Education, Office of",3,3000000,0,3000000
5214,r257,"United States<sup>b</sup> -> New Jersey -> Transit, New Jersey",United States<sup>b</sup>,New Jersey,"Transit, New Jersey",3,511533,0,511533
5214,r258,"United States<sup>b</sup> -> New Jersey -> Transportation, Department of",United States<sup>b</sup>,New Jersey,"Transportation, Department of",3,2614094,2027708,586386
5214,r259,United States<sup>b</sup> -> New Mexico,United States<sup>b</sup>,New Mexico,,2,5227599,4238566,989033
5214,r260,"United States<sup>b</sup> -> New Mexico -> Cultural Affairs, Department of",United States<sup>b</sup>,New Mexico,"Cultural Affairs, Department of",3,103000,0,103000
5214,r261,"United States<sup>b</sup> -> New Mexico -> Game and Fish, Department of",United States<sup>b</sup>,New Mexico,"Game and Fish, Department of",3,1000000,500000,500000
5214,r262,"United States<sup>b</sup> -> New Mexico -> Transportation, Department of",United States<sup>b</sup>,New Mexico,"Transportation, Department of",3,3383320,3005788,377532
5214,r263,United States<sup>b</sup> -> New Mexico -> Western State Air Resources Council,United States<sup>b</sup>,New Mexico,Western State Air Resources Council,3,741279,732778,8501
5214,r264,United States<sup>b</sup> -> New York,United States<sup>b</sup>,New York,,2,453807331,173176058,280631273
5214,r265,"United States<sup>b</sup> -> New York -> Agriculture and Markets, Department of ",United States<sup>b</sup>,New York,"Agriculture and Markets, Department of ",3,6587196,3016846,3570350
5214,r266,"United States<sup>b</sup> -> New York -> Economic Development, Department of",United States<sup>b</sup>,New York,"Economic Development, Department of",3,34942880,0,34942880
5214,r267,United States<sup>b</sup> -> New York -> Energy Research and Development Authority,United States<sup>b</sup>,New York,Energy Research and Development Authority,3,63800898,0,63800898
5214,r268,"United States<sup>b</sup> -> New York -> Environmental Conservation, Department of ",United States<sup>b</sup>,New York,"Environmental Conservation, Department of ",3,11066820,2035629,9031191
5214,r269,"United States<sup>b</sup> -> New York -> Health, Department of ",United States<sup>b</sup>,New York,"Health, Department of ",3,74723334,23197578,51525756
5214,r270,"United States<sup>b</sup> -> New York -> Mental Health, Office of ",United States<sup>b</sup>,New York,"Mental Health, Office of ",3,166944173,93791467,73152706
5214,r271,"United States<sup>b</sup> -> New York -> People with Developmental Disabilities, Office of",United States<sup>b</sup>,New York,"People with Developmental Disabilities, Office of",3,2136105,1624860,511245
5214,r272,United States<sup>b</sup> -> New York -> Power Authority,United States<sup>b</sup>,New York,Power Authority,3,11111406,0,11111406
5214,r273,United States<sup>b</sup> -> New York -> Roswell Park Comprehensive Cancer Center,United States<sup>b</sup>,New York,Roswell Park Comprehensive Cancer Center,3,66297074,44803984,21493090
5214,r274,United States<sup>b</sup> -> New York -> State Museum,United States<sup>b</sup>,New York,State Museum,3,10578496,191899,10386597
5214,r275,United States<sup>b</sup> -> New York -> Thoroughbred Breeding and Development Fund Corp.,United States<sup>b</sup>,New York,Thoroughbred Breeding and Development Fund Corp.,3,234030,0,234030
5214,r276,"United States<sup>b</sup> -> New York -> Transportation, Department of ",United States<sup>b</sup>,New York,"Transportation, Department of ",3,5384919,4513795,871124
5214,r277,United States<sup>b</sup> -> North Carolina,United States<sup>b</sup>,North Carolina,,2,35892185,9125937,26766248
5214,r278,"United States<sup>b</sup> -> North Carolina -> Agriculture and Consumer Services, Department of",United States<sup>b</sup>,North Carolina,"Agriculture and Consumer Services, Department of",3,15422911,0,15422911
5214,r279,United States<sup>b</sup> -> North Carolina -> Biotechnology Center,United States<sup>b</sup>,North Carolina,Biotechnology Center,3,3810296,0,3810296
5214,r280,"United States<sup>b</sup> -> North Carolina -> Environmental Quality, Department of",United States<sup>b</sup>,North Carolina,"Environmental Quality, Department of",3,3621969,890383,2731586
5214,r281,"United States<sup>b</sup> -> North Carolina -> Natural and Cultural Resources, Department of",United States<sup>b</sup>,North Carolina,"Natural and Cultural Resources, Department of",3,2903776,4844,2898932
5214,r282,"United States<sup>b</sup> -> North Carolina -> Transportation, Department of",United States<sup>b</sup>,North Carolina,"Transportation, Department of",3,10033233,8230710,1802523
5214,r283,United States<sup>b</sup> -> North Carolina -> Wine and Grape Growers Council,United States<sup>b</sup>,North Carolina,Wine and Grape Growers Council,3,100000,0,100000
5214,r284,United States<sup>b</sup> -> North Dakota,United States<sup>b</sup>,North Dakota,,2,18065251,4025187,14040064
5214,r285,"United States<sup>b</sup> -> North Dakota -> Agriculture, Department of",United States<sup>b</sup>,North Dakota,"Agriculture, Department of",3,817049,0,817049
5214,r286,United States<sup>b</sup> -> North Dakota -> Dairy Promotion Commission,United States<sup>b</sup>,North Dakota,Dairy Promotion Commission,3,16000,0,16000
5214,r287,United States<sup>b</sup> -> North Dakota -> Dry Pea and Lentil Council,United States<sup>b</sup>,North Dakota,Dry Pea and Lentil Council,3,80683,0,80683
5214,r288,United States<sup>b</sup> -> North Dakota -> Game and Fish Department,United States<sup>b</sup>,North Dakota,Game and Fish Department,3,789902,633957,155945
5214,r289,United States<sup>b</sup> -> North Dakota -> Historical Society of North Dakota,United States<sup>b</sup>,North Dakota,Historical Society of North Dakota,3,223743,58209,165534
5214,r290,United States<sup>b</sup> -> North Dakota -> Industrial Commission,United States<sup>b</sup>,North Dakota,Industrial Commission,3,10111495,0,10111495
5214,r291,United States<sup>b</sup> -> North Dakota -> Soybean Council,United States<sup>b</sup>,North Dakota,Soybean Council,3,1163242,0,1163242
5214,r292,"United States<sup>b</sup> -> North Dakota -> Transportation, Department of",United States<sup>b</sup>,North Dakota,"Transportation, Department of",3,3635470,3333021,302449
5214,r293,United States<sup>b</sup> -> North Dakota -> Wheat Commission,United States<sup>b</sup>,North Dakota,Wheat Commission,3,1227667,0,1227667
5214,r294,United States<sup>b</sup> -> Ohio,United States<sup>b</sup>,Ohio,,2,76169661,8463693,67705968
5214,r295,United States<sup>b</sup> -> Ohio -> Development Services Agency,United States<sup>b</sup>,Ohio,Development Services Agency,3,63372408,0,63372408
5214,r296,"United States<sup>b</sup> -> Ohio -> Education, Department of",United States<sup>b</sup>,Ohio,"Education, Department of",3,460000,460000,0
5214,r297,United States<sup>b</sup> -> Ohio -> Environmental Protection Agency,United States<sup>b</sup>,Ohio,Environmental Protection Agency,3,53352,53352,0
5214,r298,"United States<sup>b</sup> -> Ohio -> Mental Health and Addictions Services, Department of",United States<sup>b</sup>,Ohio,"Mental Health and Addictions Services, Department of",3,1500000,500000,1000000
5214,r299,"United States<sup>b</sup> -> Ohio -> Natural Resources, Department of",United States<sup>b</sup>,Ohio,"Natural Resources, Department of",3,3583207,2431255,1151952
5214,r300,United States<sup>b</sup> -> Ohio -> Rail Development Commission,United States<sup>b</sup>,Ohio,Rail Development Commission,3,220000,0,220000
5214,r301,"United States<sup>b</sup> -> Ohio -> Transportation, Department of",United States<sup>b</sup>,Ohio,"Transportation, Department of",3,6029317,5019086,1010231
5214,r302,United States<sup>b</sup> -> Ohio -> Water Development Authority,United States<sup>b</sup>,Ohio,Water Development Authority,3,951377,0,951377
5214,r303,United States<sup>b</sup> -> Oklahoma,United States<sup>b</sup>,Oklahoma,,2,30050338,7922136,22128202
5214,r304,"United States<sup>b</sup> -> Oklahoma -> Advancement of Science and Technology, Center for the ",United States<sup>b</sup>,Oklahoma,"Advancement of Science and Technology, Center for the ",3,8704830,0,8704830
5214,r305,"United States<sup>b</sup> -> Oklahoma -> Agriculture, Food, and Forestry, Department of",United States<sup>b</sup>,Oklahoma,"Agriculture, Food, and Forestry, Department of",3,454578,454578,0
5214,r306,United States<sup>b</sup> -> Oklahoma -> Grand River Dam Authority,United States<sup>b</sup>,Oklahoma,Grand River Dam Authority,3,550000,0,550000
5214,r307,"United States<sup>b</sup> -> Oklahoma -> Health, Department of",United States<sup>b</sup>,Oklahoma,"Health, Department of",3,544357,457041,87316
5214,r308,"United States<sup>b</sup> -> Oklahoma -> Human Services, Department of",United States<sup>b</sup>,Oklahoma,"Human Services, Department of",3,457147,380434,76713
5214,r309,United States<sup>b</sup> -> Oklahoma -> Tobacco Settlement Endowment Trust,United States<sup>b</sup>,Oklahoma,Tobacco Settlement Endowment Trust,3,12300000,0,12300000
5214,r310,"United States<sup>b</sup> -> Oklahoma -> Transportation, Department of",United States<sup>b</sup>,Oklahoma,"Transportation, Department of",3,5817457,5473239,344218
5214,r311,"United States<sup>b</sup> -> Oklahoma -> Wildlife Conservation, Department of",United States<sup>b</sup>,Oklahoma,"Wildlife Conservation, Department of",3,1221969,1156844,65125
5214,r312,United States<sup>b</sup> -> Oregon,United States<sup>b</sup>,Oregon,,2,30486113,11978580,18507533
5214,r313,"United States<sup>b</sup> -> Oregon -> Agriculture, Department of",United States<sup>b</sup>,Oregon,"Agriculture, Department of",3,206521,0,206521
5214,r314,United States<sup>b</sup> -> Oregon -> Business Oregon,United States<sup>b</sup>,Oregon,Business Oregon,3,9190000,0,9190000
5214,r315,"United States<sup>b</sup> -> Oregon -> Education, Department of",United States<sup>b</sup>,Oregon,"Education, Department of",3,639639,146584,493055
5214,r316,"United States<sup>b</sup> -> Oregon -> Environmental Quality, Department of",United States<sup>b</sup>,Oregon,"Environmental Quality, Department of",3,433500,0,433500
5214,r317,"United States<sup>b</sup> -> Oregon -> Fish and Wildlife, Department of",United States<sup>b</sup>,Oregon,"Fish and Wildlife, Department of",3,12424618,8832691,3591927
5214,r318,"United States<sup>b</sup> -> Oregon -> Forestry, Department of",United States<sup>b</sup>,Oregon,"Forestry, Department of",3,694549,25000,669549
5214,r319,"United States<sup>b</sup> -> Oregon -> Geology and Mineral Industries, Department of",United States<sup>b</sup>,Oregon,"Geology and Mineral Industries, Department of",3,496117,421307,74810
5214,r320,"United States<sup>b</sup> -> Oregon -> Human Services, Department of",United States<sup>b</sup>,Oregon,"Human Services, Department of",3,1488479,599557,888922
5214,r321,"United States<sup>b</sup> -> Oregon -> Transportation, Department of",United States<sup>b</sup>,Oregon,"Transportation, Department of",3,2460479,1875568,584911
5214,r322,United States<sup>b</sup> -> Oregon -> Water Resources Department,United States<sup>b</sup>,Oregon,Water Resources Department,3,1583355,0,1583355
5214,r323,United States<sup>b</sup> -> Oregon -> Watershed Enhancement Board,United States<sup>b</sup>,Oregon,Watershed Enhancement Board,3,868856,77873,790983
5214,r324,United States<sup>b</sup> -> Pennsylvania,United States<sup>b</sup>,Pennsylvania,,2,103098941,19656077,83442864
5214,r325,"United States<sup>b</sup> -> Pennsylvania -> Agriculture, Department of",United States<sup>b</sup>,Pennsylvania,"Agriculture, Department of",3,3877434,659434,3218000
5214,r326,"United States<sup>b</sup> -> Pennsylvania -> Community and Economic Development, Department of",United States<sup>b</sup>,Pennsylvania,"Community and Economic Development, Department of",3,31350000,10000000,21350000
5214,r327,"United States<sup>b</sup> -> Pennsylvania -> Conservation and Natural Resources, Department of",United States<sup>b</sup>,Pennsylvania,"Conservation and Natural Resources, Department of",3,1248,0,1248
5214,r328,"United States<sup>b</sup> -> Pennsylvania -> Environmental Protection, Department of",United States<sup>b</sup>,Pennsylvania,"Environmental Protection, Department of",3,894656,203165,691491
5214,r329,United States<sup>b</sup> -> Pennsylvania -> Fish and Boat Commission,United States<sup>b</sup>,Pennsylvania,Fish and Boat Commission,3,270914,131318,139596
5214,r330,United States<sup>b</sup> -> Pennsylvania -> Game Commission,United States<sup>b</sup>,Pennsylvania,Game Commission,3,9876885,5325815,4551070
5214,r331,"United States<sup>b</sup> -> Pennsylvania -> Health, Department of",United States<sup>b</sup>,Pennsylvania,"Health, Department of",3,53279107,0,53279107
5214,r332,United States<sup>b</sup> -> Pennsylvania -> Susquehanna River Basin Commission,United States<sup>b</sup>,Pennsylvania,Susquehanna River Basin Commission,3,335000,173500,161500
5214,r333,"United States<sup>b</sup> -> Pennsylvania -> Transportation, Department of",United States<sup>b</sup>,Pennsylvania,"Transportation, Department of",3,3213697,3162845,50852
5214,r334,United States<sup>b</sup> -> Rhode Island,United States<sup>b</sup>,Rhode Island,,2,4594040,1918239,2675801
5214,r335,United States<sup>b</sup> -> Rhode Island -> Commerce Corporation,United States<sup>b</sup>,Rhode Island,Commerce Corporation,3,1119546,0,1119546
5214,r336,"United States<sup>b</sup> -> Rhode Island -> Environmental Management, Department of; Marine Fisheries",United States<sup>b</sup>,Rhode Island,"Environmental Management, Department of; Marine Fisheries",3,3097546,1788850,1308696
5214,r337,"United States<sup>b</sup> -> Rhode Island -> Environmental Management, Department of; Narragansett Bay National Estuarine Research Reserve",United States<sup>b</sup>,Rhode Island,"Environmental Management, Department of; Narragansett Bay National Estuarine Research Reserve",3,76014,18540,57474
5214,r338,United States<sup>b</sup> -> Rhode Island -> Water Resources Board,United States<sup>b</sup>,Rhode Island,Water Resources Board,3,300934,110849,190085
5214,r339,United States<sup>b</sup> -> South Carolina,United States<sup>b</sup>,South Carolina,,2,46800816,30291219,16509597
5214,r340,"United States<sup>b</sup> -> South Carolina -> Agriculture, Department of",United States<sup>b</sup>,South Carolina,"Agriculture, Department of",3,803873,366895,436978
5214,r341,"United States<sup>b</sup> -> South Carolina -> Disabilities and Special Needs, Department of",United States<sup>b</sup>,South Carolina,"Disabilities and Special Needs, Department of",3,14226376,7292076,6934300
5214,r342,"United States<sup>b</sup> -> South Carolina -> Health and Environmental Control, Department of",United States<sup>b</sup>,South Carolina,"Health and Environmental Control, Department of",3,1388752,1388752,0
5214,r343,"United States<sup>b</sup> -> South Carolina -> Natural Resources, Department of",United States<sup>b</sup>,South Carolina,"Natural Resources, Department of",3,25080757,17705315,7375442
5214,r344,United States<sup>b</sup> -> South Carolina -> Public Service Authority,United States<sup>b</sup>,South Carolina,Public Service Authority,3,30000,0,30000
5214,r345,United States<sup>b</sup> -> South Carolina -> Research Authority,United States<sup>b</sup>,South Carolina,Research Authority,3,726551,61810,664741
5214,r346,United States<sup>b</sup> -> South Carolina -> Sea Grant Consortium,United States<sup>b</sup>,South Carolina,Sea Grant Consortium,3,2742872,2051378,691494
5214,r347,"United States<sup>b</sup> -> South Carolina -> Transportation, Department of",United States<sup>b</sup>,South Carolina,"Transportation, Department of",3,1801635,1424993,376642
5214,r348,United States<sup>b</sup> -> South Dakota,United States<sup>b</sup>,South Dakota,,2,2913274,752592,2160682
5214,r349,United States<sup>b</sup> -> South Dakota -> Corn Utilization Council,United States<sup>b</sup>,South Dakota,Corn Utilization Council,3,310000,0,310000
5214,r350,United States<sup>b</sup> -> South Dakota -> Oilseeds Council,United States<sup>b</sup>,South Dakota,Oilseeds Council,3,250865,0,250865
5214,r351,United States<sup>b</sup> -> South Dakota -> Pulse Crop Council,United States<sup>b</sup>,South Dakota,Pulse Crop Council,3,2273,0,2273
5214,r352,United States<sup>b</sup> -> South Dakota -> Science and Technology Authority,United States<sup>b</sup>,South Dakota,Science and Technology Authority,3,16021,16021,0
5214,r353,United States<sup>b</sup> -> South Dakota -> Soybean Research and Promotion Council,United States<sup>b</sup>,South Dakota,Soybean Research and Promotion Council,3,375717,0,375717
5214,r354,"United States<sup>b</sup> -> South Dakota -> Transportation, Department of",United States<sup>b</sup>,South Dakota,"Transportation, Department of",3,1321098,736571,584527
5214,r355,United States<sup>b</sup> -> South Dakota -> Weed and Pest Control Commission,United States<sup>b</sup>,South Dakota,Weed and Pest Control Commission,3,47000,0,47000
5214,r356,United States<sup>b</sup> -> South Dakota -> Wheat Commission,United States<sup>b</sup>,South Dakota,Wheat Commission,3,590300,0,590300
5214,r357,United States<sup>b</sup> -> Tennessee,United States<sup>b</sup>,Tennessee,,2,7039923,4792328,2247595
5214,r358,"United States<sup>b</sup> -> Tennessee -> Education, Department of",United States<sup>b</sup>,Tennessee,"Education, Department of",3,3363577,2083422,1280155
5214,r359,"United States<sup>b</sup> -> Tennessee -> Environment and Conservation, Department of",United States<sup>b</sup>,Tennessee,"Environment and Conservation, Department of",3,843184,497404,345780
5214,r360,United States<sup>b</sup> -> Tennessee -> Geological Survey,United States<sup>b</sup>,Tennessee,Geological Survey,3,182573,91030,91543
5214,r361,"United States<sup>b</sup> -> Tennessee -> Transportation, Department of",United States<sup>b</sup>,Tennessee,"Transportation, Department of",3,2650589,2120472,530117
5214,r362,United States<sup>b</sup> -> Texas,United States<sup>b</sup>,Texas,,2,205206977,23192709,182014268
5214,r363,"United States<sup>b</sup> -> Texas -> Agriculture, Department of",United States<sup>b</sup>,Texas,"Agriculture, Department of",3,1151413,1151413,0
5214,r364,United States<sup>b</sup> -> Texas -> Alzheimer's Research and Care Consortium (TARCC),United States<sup>b</sup>,Texas,Alzheimer's Research and Care Consortium (TARCC),3,4615313,0,4615313
5214,r365,United States<sup>b</sup> -> Texas -> Cancer Prevention and Research Institute,United States<sup>b</sup>,Texas,Cancer Prevention and Research Institute,3,169450936,0,169450936
5214,r366,"United States<sup>b</sup> -> Texas -> Environmental Quality, Commission on",United States<sup>b</sup>,Texas,"Environmental Quality, Commission on",3,2135774,1118568,1017206
5214,r367,United States<sup>b</sup> -> Texas -> Parks and Wildlife Department,United States<sup>b</sup>,Texas,Parks and Wildlife Department,3,4858066,3605276,1252790
5214,r368,"United States<sup>b</sup> -> Texas -> State Health Services, Department of ",United States<sup>b</sup>,Texas,"State Health Services, Department of ",3,1838827,1022059,816768
5214,r369,"United States<sup>b</sup> -> Texas -> Transportation, Department of",United States<sup>b</sup>,Texas,"Transportation, Department of",3,20694167,16295393,4398774
5214,r370,United States<sup>b</sup> -> Texas -> Water Development Board,United States<sup>b</sup>,Texas,Water Development Board,3,462481,0,462481
5214,r371,United States<sup>b</sup> -> Utah,United States<sup>b</sup>,Utah,,2,9205399,1721014,7484385
5214,r372,"United States<sup>b</sup> -> Utah -> Energy Development, Office of ",United States<sup>b</sup>,Utah,"Energy Development, Office of ",3,500540,0,500540
5214,r373,"United States<sup>b</sup> -> Utah -> Environmental Quality, Department of",United States<sup>b</sup>,Utah,"Environmental Quality, Department of",3,716389,123318,593071
5214,r374,"United States<sup>b</sup> -> Utah -> Health, Department of",United States<sup>b</sup>,Utah,"Health, Department of",3,4850,150,4700
5214,r375,"United States<sup>b</sup> -> Utah -> Natural Resources, Department of",United States<sup>b</sup>,Utah,"Natural Resources, Department of",3,4841922,0,4841922
5214,r376,"United States<sup>b</sup> -> Utah -> Transportation, Department of ",United States<sup>b</sup>,Utah,"Transportation, Department of ",3,3141698,1597546,1544152
5214,r377,United States<sup>b</sup> -> Vermont,United States<sup>b</sup>,Vermont,,2,1669900,1119199,550701
5214,r378,"United States<sup>b</sup> -> Vermont -> Agriculture, Food, and Markets, Agency of",United States<sup>b</sup>,Vermont,"Agriculture, Food, and Markets, Agency of",3,282511,0,282511
5214,r379,"United States<sup>b</sup> -> Vermont -> Education, Agency of",United States<sup>b</sup>,Vermont,"Education, Agency of",3,90998,0,90998
5214,r380,"United States<sup>b</sup> -> Vermont -> Human Services, Agency of",United States<sup>b</sup>,Vermont,"Human Services, Agency of",3,215000,215000,0
5214,r381,"United States<sup>b</sup> -> Vermont -> Transportation, Agency of",United States<sup>b</sup>,Vermont,"Transportation, Agency of",3,1081391,904199,177192
5214,r382,United States<sup>b</sup> -> Virginia,United States<sup>b</sup>,Virginia,,2,35552565,14998852,20553713
5214,r383,"United States<sup>b</sup> -> Virginia -> Aging and Rehabilitative Services, Department of",United States<sup>b</sup>,Virginia,"Aging and Rehabilitative Services, Department of",3,32746,32746,0
5214,r384,"United States<sup>b</sup> -> Virginia -> Agriculture and Consumer Services, Department of",United States<sup>b</sup>,Virginia,"Agriculture and Consumer Services, Department of",3,2362121,353322,2008799
5214,r385,United States<sup>b</sup> -> Virginia -> Commonwealth Health Research Board,United States<sup>b</sup>,Virginia,Commonwealth Health Research Board,3,1399997,0,1399997
5214,r386,"United States<sup>b</sup> -> Virginia -> Environmental Quality, Department of",United States<sup>b</sup>,Virginia,"Environmental Quality, Department of",3,103612,103612,0
5214,r387,"United States<sup>b</sup> -> Virginia -> Forensic Science, Department of",United States<sup>b</sup>,Virginia,"Forensic Science, Department of",3,971793,285878,685915
5214,r388,"United States<sup>b</sup> -> Virginia -> Forestry, Department of",United States<sup>b</sup>,Virginia,"Forestry, Department of",3,577211,455760,121451
5214,r389,United States<sup>b</sup> -> Virginia -> Foundation for Healthy Youth,United States<sup>b</sup>,Virginia,Foundation for Healthy Youth,3,884774,0,884774
5214,r390,"United States<sup>b</sup> -> Virginia -> Innovative Technology, Center for",United States<sup>b</sup>,Virginia,"Innovative Technology, Center for",3,6074557,2173491,3901066
5214,r391,United States<sup>b</sup> -> Virginia -> Institute for Advanced Learning and Research,United States<sup>b</sup>,Virginia,Institute for Advanced Learning and Research,3,60000,0,60000
5214,r392,United States<sup>b</sup> -> Virginia -> Marine Resources Commission,United States<sup>b</sup>,Virginia,Marine Resources Commission,3,1885300,1544188,341112
5214,r393,"United States<sup>b</sup> -> Virginia -> Mines, Minerals and Energy, Department of",United States<sup>b</sup>,Virginia,"Mines, Minerals and Energy, Department of",3,903212,381464,521748
5214,r394,"United States<sup>b</sup> -> Virginia -> Social Services, Department of",United States<sup>b</sup>,Virginia,"Social Services, Department of",3,10000,0,10000
5214,r395,"United States<sup>b</sup> -> Virginia -> Transportation, Department of",United States<sup>b</sup>,Virginia,"Transportation, Department of",3,18616858,8604050,10012808
5214,r396,"United States<sup>b</sup> -> Virginia -> Wildlife Resources, Department of",United States<sup>b</sup>,Virginia,"Wildlife Resources, Department of",3,1670384,1064341,606043
5214,r397,United States<sup>b</sup> -> Washington,United States<sup>b</sup>,Washington,,2,57239095,14747139,42491956
5214,r398,"United States<sup>b</sup> -> Washington -> Agriculture, Department of",United States<sup>b</sup>,Washington,"Agriculture, Department of",3,2974886,2824761,150125
5214,r399,United States<sup>b</sup> -> Washington -> Alfalfa Seed Commission,United States<sup>b</sup>,Washington,Alfalfa Seed Commission,3,34000,0,34000
5214,r400,United States<sup>b</sup> -> Washington -> Asparagus Commission,United States<sup>b</sup>,Washington,Asparagus Commission,3,70000,0,70000
5214,r401,United States<sup>b</sup> -> Washington -> Blueberry Commission,United States<sup>b</sup>,Washington,Blueberry Commission,3,252900,0,252900
5214,r402,"United States<sup>b</sup> -> Washington -> Commerce, Department of",United States<sup>b</sup>,Washington,"Commerce, Department of",3,4686545,0,4686545
5214,r403,United States<sup>b</sup> -> Washington -> Dairy Products Commission,United States<sup>b</sup>,Washington,Dairy Products Commission,3,30000,0,30000
5214,r404,"United States<sup>b</sup> -> Washington -> Ecology, Department of",United States<sup>b</sup>,Washington,"Ecology, Department of",3,1053172,181306,871866
5214,r405,"United States<sup>b</sup> -> Washington -> Fish and Wildlife, Department of",United States<sup>b</sup>,Washington,"Fish and Wildlife, Department of",3,9811591,5706855,4104736
5214,r406,United States<sup>b</sup> -> Washington -> Fruit Commission,United States<sup>b</sup>,Washington,Fruit Commission,3,146911,0,146911
5214,r407,United States<sup>b</sup> -> Washington -> Grain Commission,United States<sup>b</sup>,Washington,Grain Commission,3,2121448,0,2121448
5214,r408,"United States<sup>b</sup> -> Washington -> Health, Department of",United States<sup>b</sup>,Washington,"Health, Department of",3,1113483,869185,244298
5214,r409,United States<sup>b</sup> -> Washington -> Hop Commission,United States<sup>b</sup>,Washington,Hop Commission,3,281762,0,281762
5214,r410,"United States<sup>b</sup> -> Washington -> Labor and Industries, Department of",United States<sup>b</sup>,Washington,"Labor and Industries, Department of",3,3279219,689081,2590138
5214,r411,United States<sup>b</sup> -> Washington -> Mint Commission,United States<sup>b</sup>,Washington,Mint Commission,3,73825,0,73825
5214,r412,"United States<sup>b</sup> -> Washington -> Natural Resources, Department of",United States<sup>b</sup>,Washington,"Natural Resources, Department of",3,13196143,704900,12491243
5214,r413,United States<sup>b</sup> -> Washington -> Oilseeds Commission,United States<sup>b</sup>,Washington,Oilseeds Commission,3,44448,0,44448
5214,r414,"United States<sup>b</sup> -> Washington -> Pesticide Registration, Commission on",United States<sup>b</sup>,Washington,"Pesticide Registration, Commission on",3,438075,0,438075
5214,r415,United States<sup>b</sup> -> Washington -> Potato Commission,United States<sup>b</sup>,Washington,Potato Commission,3,760097,0,760097
5214,r416,United States<sup>b</sup> -> Washington -> Puget Sound Partnership,United States<sup>b</sup>,Washington,Puget Sound Partnership,3,1526263,250017,1276246
5214,r417,United States<sup>b</sup> -> Washington -> Pulse Crops Commission,United States<sup>b</sup>,Washington,Pulse Crops Commission,3,159243,0,159243
5214,r418,United States<sup>b</sup> -> Washington -> Red Raspberry Commission,United States<sup>b</sup>,Washington,Red Raspberry Commission,3,307500,0,307500
5214,r419,"United States<sup>b</sup> -> Washington -> Transportation, Department of",United States<sup>b</sup>,Washington,"Transportation, Department of",3,4890000,3477000,1413000
5214,r420,United States<sup>b</sup> -> Washington -> Tree Fruit Research Commission,United States<sup>b</sup>,Washington,Tree Fruit Research Commission,3,9668382,44034,9624348
5214,r421,United States<sup>b</sup> -> Washington -> Turfgrass Seed Commission,United States<sup>b</sup>,Washington,Turfgrass Seed Commission,3,64018,0,64018
5214,r422,United States<sup>b</sup> -> Washington -> Wine Commission,United States<sup>b</sup>,Washington,Wine Commission,3,255184,0,255184
5214,r423,United States<sup>b</sup> -> West Virginia,United States<sup>b</sup>,West Virginia,,2,10862315,6903375,3958940
5214,r424,"United States<sup>b</sup> -> West Virginia -> Agriculture, Department of",United States<sup>b</sup>,West Virginia,"Agriculture, Department of",3,202365,202365,0
5214,r425,United States<sup>b</sup> -> West Virginia -> Geological and Economic Survey,United States<sup>b</sup>,West Virginia,Geological and Economic Survey,3,1854645,166846,1687799
5214,r426,United States<sup>b</sup> -> West Virginia -> Higher Education Policy Commission,United States<sup>b</sup>,West Virginia,Higher Education Policy Commission,3,5483928,3898885,1585043
5214,r427,"United States<sup>b</sup> -> West Virginia -> Justice and Community Services, Division of",United States<sup>b</sup>,West Virginia,"Justice and Community Services, Division of",3,8000,0,8000
5214,r428,"United States<sup>b</sup> -> West Virginia -> Natural Resources, Department of",United States<sup>b</sup>,West Virginia,"Natural Resources, Department of",3,1285162,1002569,282593
5214,r429,"United States<sup>b</sup> -> West Virginia -> Transportation, Department of",United States<sup>b</sup>,West Virginia,"Transportation, Department of",3,2028215,1632710,395505
5214,r430,United States<sup>b</sup> -> Wisconsin,United States<sup>b</sup>,Wisconsin,,2,14340014,8358684,5981330
5214,r431,"United States<sup>b</sup> -> Wisconsin -> Agriculture, Trade and Consumer Protection, Department of",United States<sup>b</sup>,Wisconsin,"Agriculture, Trade and Consumer Protection, Department of",3,985099,985099,0
5214,r432,United States<sup>b</sup> -> Wisconsin -> Economic Development Corporation,United States<sup>b</sup>,Wisconsin,Economic Development Corporation,3,3825000,0,3825000
5214,r433,"United States<sup>b</sup> -> Wisconsin -> Natural Resources, Department of",United States<sup>b</sup>,Wisconsin,"Natural Resources, Department of",3,5423223,3596307,1826916
5214,r434,"United States<sup>b</sup> -> Wisconsin -> Transportation, Department of",United States<sup>b</sup>,Wisconsin,"Transportation, Department of",3,4106692,3777278,329414
5214,r435,United States<sup>b</sup> -> Wyoming,United States<sup>b</sup>,Wyoming,,2,6391060,3555506,2835554
5214,r436,"United States<sup>b</sup> -> Wyoming -> Agriculture, Department of",United States<sup>b</sup>,Wyoming,"Agriculture, Department of",3,561674,192300,369374
5214,r437,United States<sup>b</sup> -> Wyoming -> Business Council,United States<sup>b</sup>,Wyoming,Business Council,3,847500,0,847500
5214,r438,"United States<sup>b</sup> -> Wyoming -> Corrections, Department of",United States<sup>b</sup>,Wyoming,"Corrections, Department of",3,123280,0,123280
5214,r439,United States<sup>b</sup> -> Wyoming -> Enhanced Oil Recovery Institute,United States<sup>b</sup>,Wyoming,Enhanced Oil Recovery Institute,3,1500000,1000000,500000
5214,r440,United States<sup>b</sup> -> Wyoming -> Game and Fish Department,United States<sup>b</sup>,Wyoming,Game and Fish Department,3,1689237,1162443,526794
5214,r441,United States<sup>b</sup> -> Wyoming -> State Geological Survey,United States<sup>b</sup>,Wyoming,State Geological Survey,3,184676,172547,12129
5214,r442,"United States<sup>b</sup> -> Wyoming -> Transportation, Department of",United States<sup>b</sup>,Wyoming,"Transportation, Department of",3,1240805,1028216,212589
5214,r443,United States<sup>b</sup> -> Wyoming -> Water Development Office,United States<sup>b</sup>,Wyoming,Water Development Office,3,243888,0,243888
