table_id,row_id,_b_state_and_department_or_agency_b_full_path,_b_state_and_department_or_agency_b_level_1,_b_state_and_department_or_agency_b_level_2,_b_state_and_department_or_agency_b_level_3,_b_state_and_department_or_agency_b_hierarchy_depth,field_all_r_d_expenditures,field_source_of_funds_federal_government,field_source_of_funds_state_and_all_othersa
7702,r001,United States<sup>b</sup>,United States<sup>b</sup>,,,1,2471471226,612123519,1859347707
7702,r002,United States<sup>b</sup> -> Alabama,United States<sup>b</sup>,Alabama,,2,29812345,6067898,23744447
7702,r003,"United States<sup>b</sup> -> Alabama -> Commerce, Department of",United States<sup>b</sup>,Alabama,"Commerce, Department of",3,3000000,0,3000000
7702,r004,"United States<sup>b</sup> -> Alabama -> Conservation and Natural Resources, Department of; Wildlife and Freshwater Fisheries Division",United States<sup>b</sup>,Alabama,"Conservation and Natural Resources, Department of; Wildlife and Freshwater Fisheries Division",3,2300326,1911978,388348
7702,r005,"United States<sup>b</sup> -> Alabama -> Economic & Community Affairs, Department of ",United States<sup>b</sup>,Alabama,"Economic & Community Affairs, Department of ",3,533590,0,533590
7702,r006,"United States<sup>b</sup> -> Alabama -> Education, Department of",United States<sup>b</sup>,Alabama,"Education, Department of",3,13196000,247000,12949000
7702,r007,"United States<sup>b</sup> -> Alabama -> Forensic Sciences, Department of",United States<sup>b</sup>,Alabama,"Forensic Sciences, Department of",3,272635,0,272635
7702,r008,United States<sup>b</sup> -> Alabama -> Geological Survey,United States<sup>b</sup>,Alabama,Geological Survey,3,2690719,1060928,1629791
7702,r009,"United States<sup>b</sup> -> Alabama -> Marine Environmental Science Consortium, Dauphin Island Sea Lab",United States<sup>b</sup>,Alabama,"Marine Environmental Science Consortium, Dauphin Island Sea Lab",3,1175774,889691,286083
7702,r010,United States<sup>b</sup> -> Alabama -> Supercomputer Authority,United States<sup>b</sup>,Alabama,Supercomputer Authority,3,4432300,0,4432300
7702,r011,"United States<sup>b</sup> -> Alabama -> Transportation, Department of",United States<sup>b</sup>,Alabama,"Transportation, Department of",3,2211001,1958301,252700
7702,r012,United States<sup>b</sup> -> Alaska,United States<sup>b</sup>,Alaska,,2,19671388,11068861,8602527
7702,r013,"United States<sup>b</sup> -> Alaska -> Environmental Conservation, Department of ",United States<sup>b</sup>,Alaska,"Environmental Conservation, Department of ",3,866695,633882,232813
7702,r014,United States<sup>b</sup> -> Alaska -> Housing Finance Corporation,United States<sup>b</sup>,Alaska,Housing Finance Corporation,3,500000,0,500000
7702,r015,"United States<sup>b</sup> -> Alaska -> Natural Resources, Department of; Division of Geological and Geophysical Surveys",United States<sup>b</sup>,Alaska,"Natural Resources, Department of; Division of Geological and Geophysical Surveys",3,9086400,2149354,6937046
7702,r016,United States<sup>b</sup> -> Alaska -> Railroad Corporation,United States<sup>b</sup>,Alaska,Railroad Corporation,3,6685193,6279925,405268
7702,r017,United States<sup>b</sup> -> Alaska -> Seafood Marketing Institute,United States<sup>b</sup>,Alaska,Seafood Marketing Institute,3,26000,0,26000
7702,r018,"United States<sup>b</sup> -> Alaska -> Transportation and Public Facilities, Department of",United States<sup>b</sup>,Alaska,"Transportation and Public Facilities, Department of",3,2507100,2005700,501400
7702,r019,United States<sup>b</sup> -> Arizona,United States<sup>b</sup>,Arizona,,2,15011508,5070319,9941189
7702,r020,"United States<sup>b</sup> -> Arizona -> Agriculture, Department of",United States<sup>b</sup>,Arizona,"Agriculture, Department of",3,1167546,1011009,156537
7702,r021,United States<sup>b</sup> -> Arizona -> Game and Fish Department,United States<sup>b</sup>,Arizona,Game and Fish Department,3,1585868,1515321,70547
7702,r022,"United States<sup>b</sup> -> Arizona -> Health Services, Department of",United States<sup>b</sup>,Arizona,"Health Services, Department of",3,8467153,0,8467153
7702,r023,"United States<sup>b</sup> -> Arizona -> Juvenile Corrections, Department of ",United States<sup>b</sup>,Arizona,"Juvenile Corrections, Department of ",3,610954,0,610954
7702,r024,"United States<sup>b</sup> -> Arizona -> Transportation, Department of",United States<sup>b</sup>,Arizona,"Transportation, Department of",3,3179987,2543989,635998
7702,r025,United States<sup>b</sup> -> Arkansas,United States<sup>b</sup>,Arkansas,,2,9908767,983181,8925586
7702,r026,"United States<sup>b</sup> -> Arkansas -> Agriculture, Department of",United States<sup>b</sup>,Arkansas,"Agriculture, Department of",3,152420,0,152420
7702,r027,United States<sup>b</sup> -> Arkansas -> Beef Council,United States<sup>b</sup>,Arkansas,Beef Council,3,60406,0,60406
7702,r028,United States<sup>b</sup> -> Arkansas -> Corn and Grain Sorghum Promotion Board,United States<sup>b</sup>,Arkansas,Corn and Grain Sorghum Promotion Board,3,992000,0,992000
7702,r029,United States<sup>b</sup> -> Arkansas -> Economic Development Commission,United States<sup>b</sup>,Arkansas,Economic Development Commission,3,2075000,0,2075000
7702,r030,United States<sup>b</sup> -> Arkansas -> Game and Fish Commission,United States<sup>b</sup>,Arkansas,Game and Fish Commission,3,872648,743608,129040
7702,r031,"United States<sup>b</sup> -> Arkansas -> Midwest Dairy Association, Arkansas Division",United States<sup>b</sup>,Arkansas,"Midwest Dairy Association, Arkansas Division",3,9700,0,9700
7702,r032,United States<sup>b</sup> -> Arkansas -> Natural Heritage Commission,United States<sup>b</sup>,Arkansas,Natural Heritage Commission,3,195378,18601,176777
7702,r033,United States<sup>b</sup> -> Arkansas -> Rice Research and Promotion Board,United States<sup>b</sup>,Arkansas,Rice Research and Promotion Board,3,2775000,0,2775000
7702,r034,United States<sup>b</sup> -> Arkansas -> Soybean Promotion Board,United States<sup>b</sup>,Arkansas,Soybean Promotion Board,3,2400000,0,2400000
7702,r035,"United States<sup>b</sup> -> Arkansas -> Transportation, Department of",United States<sup>b</sup>,Arkansas,"Transportation, Department of",3,276215,220972,55243
7702,r036,United States<sup>b</sup> -> Arkansas -> Wheat Promotion Board,United States<sup>b</sup>,Arkansas,Wheat Promotion Board,3,100000,0,100000
7702,r037,United States<sup>b</sup> -> California,United States<sup>b</sup>,California,,2,523819635,28494592,495325043
7702,r038,United States<sup>b</sup> -> California -> Air Resources Board,United States<sup>b</sup>,California,Air Resources Board,3,16703318,0,16703318
7702,r039,United States<sup>b</sup> -> California -> Children and Families Commission (First 5 California),United States<sup>b</sup>,California,Children and Families Commission (First 5 California),3,4493407,0,4493407
7702,r040,"United States<sup>b</sup> -> California -> Conservation, Department of",United States<sup>b</sup>,California,"Conservation, Department of",3,1508933,280000,1228933
7702,r041,"United States<sup>b</sup> -> California -> Corrections and Rehabilitation, Department of",United States<sup>b</sup>,California,"Corrections and Rehabilitation, Department of",3,1139419,0,1139419
7702,r042,United States<sup>b</sup> -> California -> Covered California,United States<sup>b</sup>,California,Covered California,3,3793141,0,3793141
7702,r043,United States<sup>b</sup> -> California -> Dairy Council,United States<sup>b</sup>,California,Dairy Council,3,18672,0,18672
7702,r044,United States<sup>b</sup> -> California -> Delta Stewardship Council,United States<sup>b</sup>,California,Delta Stewardship Council,3,4093320,685670,3407650
7702,r045,United States<sup>b</sup> -> California -> Energy Commission,United States<sup>b</sup>,California,Energy Commission,3,230900000,0,230900000
7702,r046,"United States<sup>b</sup> -> California -> Environmental Health Hazard Assessment, Office of",United States<sup>b</sup>,California,"Environmental Health Hazard Assessment, Office of",3,17522940,0,17522940
7702,r047,"United States<sup>b</sup> -> California -> Food and Agriculture, Department of",United States<sup>b</sup>,California,"Food and Agriculture, Department of",3,4686177,54964,4631213
7702,r048,"United States<sup>b</sup> -> California -> Forestry and Fire Protection, Department of",United States<sup>b</sup>,California,"Forestry and Fire Protection, Department of",3,5500000,0,5500000
7702,r049,United States<sup>b</sup> -> California -> Horse Racing Board,United States<sup>b</sup>,California,Horse Racing Board,3,695130,0,695130
7702,r050,"United States<sup>b</sup> -> California -> Housing and Community Development, Department of",United States<sup>b</sup>,California,"Housing and Community Development, Department of",3,150000,0,150000
7702,r051,United States<sup>b</sup> -> California -> Institute for Regenerative Medicine,United States<sup>b</sup>,California,Institute for Regenerative Medicine,3,95739916,0,95739916
7702,r052,United States<sup>b</sup> -> California -> Mental Health Services Oversight and Accountability Commission,United States<sup>b</sup>,California,Mental Health Services Oversight and Accountability Commission,3,2500000,0,2500000
7702,r053,"United States<sup>b</sup> -> California -> Motor Vehicles, Department of",United States<sup>b</sup>,California,"Motor Vehicles, Department of",3,1551423,0,1551423
7702,r054,"United States<sup>b</sup> -> California -> Parks And Recreation, Department of",United States<sup>b</sup>,California,"Parks And Recreation, Department of",3,1500000,0,1500000
7702,r055,"United States<sup>b</sup> -> California -> Pesticide Regulation, Department of ",United States<sup>b</sup>,California,"Pesticide Regulation, Department of ",3,11642098,190006,11452092
7702,r056,"United States<sup>b</sup> -> California -> Public Health, Department of",United States<sup>b</sup>,California,"Public Health, Department of",3,6089200,44000,6045200
7702,r057,"United States<sup>b</sup> -> California -> Public Utilities Commission, Executive Division",United States<sup>b</sup>,California,"Public Utilities Commission, Executive Division",3,37000000,0,37000000
7702,r058,"United States<sup>b</sup> -> California -> Rehabilitation, Department of ",United States<sup>b</sup>,California,"Rehabilitation, Department of ",3,2702614,2702614,0
7702,r059,"United States<sup>b</sup> -> California -> Resources Recycling and Recovery, Department of ",United States<sup>b</sup>,California,"Resources Recycling and Recovery, Department of ",3,155635,0,155635
7702,r060,"United States<sup>b</sup> -> California -> Social Services, Department of ",United States<sup>b</sup>,California,"Social Services, Department of ",3,3585336,3024462,560874
7702,r061,United States<sup>b</sup> -> California -> State Coastal Conservancy,United States<sup>b</sup>,California,State Coastal Conservancy,3,835489,154340,681149
7702,r062,United States<sup>b</sup> -> California -> State Water Resources Control Board,United States<sup>b</sup>,California,State Water Resources Control Board,3,5377799,283580,5094219
7702,r063,"United States<sup>b</sup> -> California -> Toxic Substances Control, Department of",United States<sup>b</sup>,California,"Toxic Substances Control, Department of",3,1887600,0,1887600
7702,r064,"United States<sup>b</sup> -> California -> Transportation, Department of",United States<sup>b</sup>,California,"Transportation, Department of",3,47716505,21074351,26642154
7702,r065,"United States<sup>b</sup> -> California -> Water Resources, Department of",United States<sup>b</sup>,California,"Water Resources, Department of",3,14331563,605,14330958
7702,r066,United States<sup>b</sup> -> Colorado,United States<sup>b</sup>,Colorado,,2,38436248,6546643,31889605
7702,r067,"United States<sup>b</sup> -> Colorado -> Agriculture, Department of",United States<sup>b</sup>,Colorado,"Agriculture, Department of",3,676649,665946,10703
7702,r068,"United States<sup>b</sup> -> Colorado -> Economic Development and International Trade, Office of",United States<sup>b</sup>,Colorado,"Economic Development and International Trade, Office of",3,21331814,0,21331814
7702,r069,"United States<sup>b</sup> -> Colorado -> Higher Education Competitive, Research Authority",United States<sup>b</sup>,Colorado,"Higher Education Competitive, Research Authority",3,1748478,0,1748478
7702,r070,"United States<sup>b</sup> -> Colorado -> Natural Resources, Department of",United States<sup>b</sup>,Colorado,"Natural Resources, Department of",3,7530151,2441788,5088363
7702,r071,"United States<sup>b</sup> -> Colorado -> Public Health and Environment, Department of",United States<sup>b</sup>,Colorado,"Public Health and Environment, Department of",3,2591744,43144,2548600
7702,r072,"United States<sup>b</sup> -> Colorado -> Public Safety, Department of; Division of Criminal Justice",United States<sup>b</sup>,Colorado,"Public Safety, Department of; Division of Criminal Justice",3,1040036,120899,919137
7702,r073,"United States<sup>b</sup> -> Colorado -> Transportation, Department of",United States<sup>b</sup>,Colorado,"Transportation, Department of",3,3274866,3274866,0
7702,r074,United States<sup>b</sup> -> Colorado -> Wine Industry Development Board,United States<sup>b</sup>,Colorado,Wine Industry Development Board,3,242510,0,242510
7702,r075,United States<sup>b</sup> -> Connecticut,United States<sup>b</sup>,Connecticut,,2,55050702,15879739,39170963
7702,r076,United States<sup>b</sup> -> Connecticut -> Agricultural Experiment Station,United States<sup>b</sup>,Connecticut,Agricultural Experiment Station,3,13302928,5799104,7503824
7702,r077,"United States<sup>b</sup> -> Connecticut -> Energy and Environmental Protection, Department of",United States<sup>b</sup>,Connecticut,"Energy and Environmental Protection, Department of",3,7445420,5822449,1622971
7702,r078,United States<sup>b</sup> -> Connecticut -> Innovation Inc.,United States<sup>b</sup>,Connecticut,Innovation Inc.,3,23315658,0,23315658
7702,r079,"United States<sup>b</sup> -> Connecticut -> Mental Health and Addiction Services, Department of",United States<sup>b</sup>,Connecticut,"Mental Health and Addiction Services, Department of",3,6966358,536219,6430139
7702,r080,"United States<sup>b</sup> -> Connecticut -> Public Health, Department of",United States<sup>b</sup>,Connecticut,"Public Health, Department of",3,20967,20967,0
7702,r081,"United States<sup>b</sup> -> Connecticut -> Social Services, Department of",United States<sup>b</sup>,Connecticut,"Social Services, Department of",3,1591082,1591082,0
7702,r082,"United States<sup>b</sup> -> Connecticut -> Transportation, Department of",United States<sup>b</sup>,Connecticut,"Transportation, Department of",3,2408289,2109918,298371
7702,r083,United States<sup>b</sup> -> Delaware,United States<sup>b</sup>,Delaware,,2,3338773,1355648,1983125
7702,r084,United States<sup>b</sup> -> Delaware -> Geological Survey,United States<sup>b</sup>,Delaware,Geological Survey,3,1945219,307938,1637281
7702,r085,"United States<sup>b</sup> -> Delaware -> Natural Resources and Environmental Control, Department of",United States<sup>b</sup>,Delaware,"Natural Resources and Environmental Control, Department of",3,257515,205974,51541
7702,r086,United States<sup>b</sup> -> Delaware -> Sustainable Energy Utility,United States<sup>b</sup>,Delaware,Sustainable Energy Utility,3,46054,0,46054
7702,r087,"United States<sup>b</sup> -> Delaware -> Transportation, Department of",United States<sup>b</sup>,Delaware,"Transportation, Department of",3,1089985,841736,248249
7702,r088,United States<sup>b</sup> -> District of Columbia,United States<sup>b</sup>,District of Columbia,,2,8128666,6245794,1882872
7702,r089,"United States<sup>b</sup> -> District of Columbia -> Energy and Environment, Department of",United States<sup>b</sup>,District of Columbia,"Energy and Environment, Department of",3,207000,207000,0
7702,r090,"United States<sup>b</sup> -> District of Columbia -> Forensic Sciences, Department of",United States<sup>b</sup>,District of Columbia,"Forensic Sciences, Department of",3,75566,30000,45566
7702,r091,"United States<sup>b</sup> -> District of Columbia -> Health, Department of",United States<sup>b</sup>,District of Columbia,"Health, Department of",3,5942318,5765769,176549
7702,r092,"United States<sup>b</sup> -> District of Columbia -> Transportation, Department of",United States<sup>b</sup>,District of Columbia,"Transportation, Department of",3,303782,243025,60757
7702,r093,United States<sup>b</sup> -> District of Columbia -> Water and Sewer Authority,United States<sup>b</sup>,District of Columbia,Water and Sewer Authority,3,1600000,0,1600000
7702,r094,United States<sup>b</sup> -> Florida,United States<sup>b</sup>,Florida,,2,178360429,25068596,153291833
7702,r095,"United States<sup>b</sup> -> Florida -> Agriculture and Consumer Services, Department of",United States<sup>b</sup>,Florida,"Agriculture and Consumer Services, Department of",3,16258186,5271571,10986615
7702,r096,"United States<sup>b</sup> -> Florida -> Business and Professional Regulation, Department of",United States<sup>b</sup>,Florida,"Business and Professional Regulation, Department of",3,100000,0,100000
7702,r097,"United States<sup>b</sup> -> Florida -> Citrus, Department of",United States<sup>b</sup>,Florida,"Citrus, Department of",3,999748,0,999748
7702,r098,"United States<sup>b</sup> -> Florida -> Environmental Protection, Department of",United States<sup>b</sup>,Florida,"Environmental Protection, Department of",3,129087,129087,0
7702,r099,United States<sup>b</sup> -> Florida -> Fish and Wildlife Conservation Commission,United States<sup>b</sup>,Florida,Fish and Wildlife Conservation Commission,3,57203692,14307739,42895953
7702,r100,"United States<sup>b</sup> -> Florida -> Health, Department of",United States<sup>b</sup>,Florida,"Health, Department of",3,92142161,0,92142161
7702,r101,United States<sup>b</sup> -> Florida -> Space Florida,United States<sup>b</sup>,Florida,Space Florida,3,1300000,0,1300000
7702,r102,"United States<sup>b</sup> -> Florida -> Transportation, Department of",United States<sup>b</sup>,Florida,"Transportation, Department of",3,10227555,5360199,4867356
7702,r103,United States<sup>b</sup> -> Georgia,United States<sup>b</sup>,Georgia,,2,18798826,17725257,1073569
7702,r104,"United States<sup>b</sup> -> Georgia -> Natural Resources, Department of",United States<sup>b</sup>,Georgia,"Natural Resources, Department of",3,818245,710803,107442
7702,r105,United States<sup>b</sup> -> Georgia -> Southern States Energy Board,United States<sup>b</sup>,Georgia,Southern States Energy Board,3,11557770,11369004,188766
7702,r106,"United States<sup>b</sup> -> Georgia -> Transportation, Department of",United States<sup>b</sup>,Georgia,"Transportation, Department of",3,6422811,5645450,777361
7702,r107,United States<sup>b</sup> -> Hawaii,United States<sup>b</sup>,Hawaii,,2,10315823,8334826,1980997
7702,r108,"United States<sup>b</sup> -> Hawaii -> Agriculture, Department of",United States<sup>b</sup>,Hawaii,"Agriculture, Department of",3,484028,484028,0
7702,r109,"United States<sup>b</sup> -> Hawaii -> Business, Economic Development, and Tourism, Department of",United States<sup>b</sup>,Hawaii,"Business, Economic Development, and Tourism, Department of",3,2538265,2188265,350000
7702,r110,"United States<sup>b</sup> -> Hawaii -> Land and Natural Resources, Department of",United States<sup>b</sup>,Hawaii,"Land and Natural Resources, Department of",3,280000,145000,135000
7702,r111,United States<sup>b</sup> -> Hawaii -> Natural Energy Laboratory of Hawaii Authority,United States<sup>b</sup>,Hawaii,Natural Energy Laboratory of Hawaii Authority,3,2000000,2000000,0
7702,r112,"United States<sup>b</sup> -> Hawaii -> Transportation, Department of",United States<sup>b</sup>,Hawaii,"Transportation, Department of",3,5013530,3517533,1495997
7702,r113,United States<sup>b</sup> -> Idaho,United States<sup>b</sup>,Idaho,,2,18210054,9698956,8511098
7702,r114,"United States<sup>b</sup> -> Idaho -> Agriculture, Department of",United States<sup>b</sup>,Idaho,"Agriculture, Department of",3,336276,336276,0
7702,r115,United States<sup>b</sup> -> Idaho -> Alfalfa and Clover Seed Commission,United States<sup>b</sup>,Idaho,Alfalfa and Clover Seed Commission,3,2300,0,2300
7702,r116,United States<sup>b</sup> -> Idaho -> Barley Commission,United States<sup>b</sup>,Idaho,Barley Commission,3,210712,0,210712
7702,r117,United States<sup>b</sup> -> Idaho -> Bean Commission,United States<sup>b</sup>,Idaho,Bean Commission,3,40640,0,40640
7702,r118,United States<sup>b</sup> -> Idaho -> Beef Council,United States<sup>b</sup>,Idaho,Beef Council,3,123053,0,123053
7702,r119,"United States<sup>b</sup> -> Idaho -> Commerce, Department of ",United States<sup>b</sup>,Idaho,"Commerce, Department of ",3,1020240,0,1020240
7702,r120,United States<sup>b</sup> -> Idaho -> Dairy West,United States<sup>b</sup>,Idaho,Dairy West,3,2805947,0,2805947
7702,r121,"United States<sup>b</sup> -> Idaho -> Environmental Quality, Department of",United States<sup>b</sup>,Idaho,"Environmental Quality, Department of",3,578257,115127,463130
7702,r122,"United States<sup>b</sup> -> Idaho -> Fish and Game, Department of",United States<sup>b</sup>,Idaho,"Fish and Game, Department of",3,8895129,7365732,1529397
7702,r123,United States<sup>b</sup> -> Idaho -> Honey Commission,United States<sup>b</sup>,Idaho,Honey Commission,3,3500,0,3500
7702,r124,United States<sup>b</sup> -> Idaho -> Mint Commission,United States<sup>b</sup>,Idaho,Mint Commission,3,14867,0,14867
7702,r125,United States<sup>b</sup> -> Idaho -> Oilseed Commission,United States<sup>b</sup>,Idaho,Oilseed Commission,3,65000,0,65000
7702,r126,United States<sup>b</sup> -> Idaho -> Pea and Lentil Commission,United States<sup>b</sup>,Idaho,Pea and Lentil Commission,3,103479,0,103479
7702,r127,United States<sup>b</sup> -> Idaho -> Potato Commission,United States<sup>b</sup>,Idaho,Potato Commission,3,747788,0,747788
7702,r128,United States<sup>b</sup> -> Idaho -> Transportation Department,United States<sup>b</sup>,Idaho,Transportation Department,3,2095738,1881821,213917
7702,r129,United States<sup>b</sup> -> Idaho -> Wheat Commission,United States<sup>b</sup>,Idaho,Wheat Commission,3,1167128,0,1167128
7702,r130,United States<sup>b</sup> -> Illinois,United States<sup>b</sup>,Illinois,,2,16213542,7152110,9061432
7702,r131,"United States<sup>b</sup> -> Illinois -> Children and Family Services, Department of",United States<sup>b</sup>,Illinois,"Children and Family Services, Department of",3,2468113,0,2468113
7702,r132,"United States<sup>b</sup> -> Illinois -> Midwest Dairy Association, Illinois Division",United States<sup>b</sup>,Illinois,"Midwest Dairy Association, Illinois Division",3,19400,0,19400
7702,r133,United States<sup>b</sup> -> Illinois -> Nutrient Research and Education Council,United States<sup>b</sup>,Illinois,Nutrient Research and Education Council,3,4000000,0,4000000
7702,r134,"United States<sup>b</sup> -> Illinois -> Public Health, Department of",United States<sup>b</sup>,Illinois,"Public Health, Department of",3,295040,0,295040
7702,r135,"United States<sup>b</sup> -> Illinois -> Transportation, Department of",United States<sup>b</sup>,Illinois,"Transportation, Department of",3,9430989,7152110,2278879
7702,r136,United States<sup>b</sup> -> Indiana,United States<sup>b</sup>,Indiana,,2,10485205,6875499,3609706
7702,r137,United States<sup>b</sup> -> Indiana -> Economic Development Corporation,United States<sup>b</sup>,Indiana,Economic Development Corporation,3,1424123,0,1424123
7702,r138,"United States<sup>b</sup> -> Indiana -> Environmental Management, Department of",United States<sup>b</sup>,Indiana,"Environmental Management, Department of",3,16935,16935,0
7702,r139,"United States<sup>b</sup> -> Indiana -> Natural Resources, Department of",United States<sup>b</sup>,Indiana,"Natural Resources, Department of",3,1086728,430027,656701
7702,r140,United States<sup>b</sup> -> Indiana -> St. Joseph River Basin Commission,United States<sup>b</sup>,Indiana,St. Joseph River Basin Commission,3,32490,0,32490
7702,r141,"United States<sup>b</sup> -> Indiana -> Transportation, Department of",United States<sup>b</sup>,Indiana,"Transportation, Department of",3,7924929,6428537,1496392
7702,r142,United States<sup>b</sup> -> Iowa,United States<sup>b</sup>,Iowa,,2,10579028,4841194,5737834
7702,r143,United States<sup>b</sup> -> Iowa -> Beef Industry Council,United States<sup>b</sup>,Iowa,Beef Industry Council,3,58898,0,58898
7702,r144,"United States<sup>b</sup> -> Iowa -> Human Rights, Criminal and Juvenile Justice Planning, Division of, Department of",United States<sup>b</sup>,Iowa,"Human Rights, Criminal and Juvenile Justice Planning, Division of, Department of",3,472395,166799,305596
7702,r145,"United States<sup>b</sup> -> Iowa -> Midwest Dairy Association, Iowa Division",United States<sup>b</sup>,Iowa,"Midwest Dairy Association, Iowa Division",3,111550,0,111550
7702,r146,"United States<sup>b</sup> -> Iowa -> Natural Resources, Department of",United States<sup>b</sup>,Iowa,"Natural Resources, Department of",3,2994029,1762651,1231378
7702,r147,"United States<sup>b</sup> -> Iowa -> Transportation, Department of",United States<sup>b</sup>,Iowa,"Transportation, Department of",3,6942156,2911744,4030412
7702,r148,United States<sup>b</sup> -> Kansas,United States<sup>b</sup>,Kansas,,2,15002554,8343437,6659117
7702,r149,United States<sup>b</sup> -> Kansas -> Corn Commission,United States<sup>b</sup>,Kansas,Corn Commission,3,654979,0,654979
7702,r150,United States<sup>b</sup> -> Kansas -> Grain Sorghum Commission,United States<sup>b</sup>,Kansas,Grain Sorghum Commission,3,277300,0,277300
7702,r151,"United States<sup>b</sup> -> Kansas -> Midwest Dairy Association, Kansas Division",United States<sup>b</sup>,Kansas,"Midwest Dairy Association, Kansas Division",3,14550,0,14550
7702,r152,United States<sup>b</sup> -> Kansas -> Soybean Commission,United States<sup>b</sup>,Kansas,Soybean Commission,3,1200000,0,1200000
7702,r153,United States<sup>b</sup> -> Kansas -> State Board of Regents,United States<sup>b</sup>,Kansas,State Board of Regents,3,998754,0,998754
7702,r154,United States<sup>b</sup> -> Kansas -> Sunflower Commission,United States<sup>b</sup>,Kansas,Sunflower Commission,3,20000,0,20000
7702,r155,"United States<sup>b</sup> -> Kansas -> Transportation, Department of",United States<sup>b</sup>,Kansas,"Transportation, Department of",3,3237535,2177974,1059561
7702,r156,United States<sup>b</sup> -> Kansas -> Water Office,United States<sup>b</sup>,Kansas,Water Office,3,1011797,51657,960140
7702,r157,United States<sup>b</sup> -> Kansas -> Wheat Commission,United States<sup>b</sup>,Kansas,Wheat Commission,3,1378000,0,1378000
7702,r158,"United States<sup>b</sup> -> Kansas -> Wildlife and Parks, Department of",United States<sup>b</sup>,Kansas,"Wildlife and Parks, Department of",3,6209639,6113806,95833
7702,r159,United States<sup>b</sup> -> Kentucky,United States<sup>b</sup>,Kentucky,,2,29737068,7548030,22189038
7702,r160,"United States<sup>b</sup> -> Kentucky -> Behavioral Health, Developmental and Intellectual Disabilities",United States<sup>b</sup>,Kentucky,"Behavioral Health, Developmental and Intellectual Disabilities",3,67500,0,67500
7702,r161,"United States<sup>b</sup> -> Kentucky -> Economic Development, Cabinet for",United States<sup>b</sup>,Kentucky,"Economic Development, Cabinet for",3,3048739,0,3048739
7702,r162,"United States<sup>b</sup> -> Kentucky -> Fish and Wildlife Resources, Department of ",United States<sup>b</sup>,Kentucky,"Fish and Wildlife Resources, Department of ",3,2230154,1412298,817856
7702,r163,United States<sup>b</sup> -> Kentucky -> Horse Racing Commission,United States<sup>b</sup>,Kentucky,Horse Racing Commission,3,216983,0,216983
7702,r164,"United States<sup>b</sup> -> Kentucky -> Nature Preserves, Office of Kentucky",United States<sup>b</sup>,Kentucky,"Nature Preserves, Office of Kentucky",3,175935,0,175935
7702,r165,"United States<sup>b</sup> -> Kentucky -> Postsecondary Education, Council on",United States<sup>b</sup>,Kentucky,"Postsecondary Education, Council on",3,11086500,0,11086500
7702,r166,"United States<sup>b</sup> -> Kentucky -> Public Health, Department for ",United States<sup>b</sup>,Kentucky,"Public Health, Department for ",3,3561572,0,3561572
7702,r167,United States<sup>b</sup> -> Kentucky -> Public Service Commission,United States<sup>b</sup>,Kentucky,Public Service Commission,3,21000,0,21000
7702,r168,United States<sup>b</sup> -> Kentucky -> Soybean Promotion Board,United States<sup>b</sup>,Kentucky,Soybean Promotion Board,3,517000,0,517000
7702,r169,United States<sup>b</sup> -> Kentucky -> Transportation Cabinet,United States<sup>b</sup>,Kentucky,Transportation Cabinet,3,8811685,6135732,2675953
7702,r170,United States<sup>b</sup> -> Louisiana,United States<sup>b</sup>,Louisiana,,2,32115461,19523775,12591686
7702,r171,"United States<sup>b</sup> -> Louisiana -> Agriculture and Forestry, Department of",United States<sup>b</sup>,Louisiana,"Agriculture and Forestry, Department of",3,4946,0,4946
7702,r172,United States<sup>b</sup> -> Louisiana -> Board of Regents,United States<sup>b</sup>,Louisiana,Board of Regents,3,13492921,7159966,6332955
7702,r173,United States<sup>b</sup> -> Louisiana -> Coastal Protection and Restoration Authority,United States<sup>b</sup>,Louisiana,Coastal Protection and Restoration Authority,3,3573798,667842,2905956
7702,r174,"United States<sup>b</sup> -> Louisiana -> Transportation and Development, Department of ",United States<sup>b</sup>,Louisiana,"Transportation and Development, Department of ",3,9185327,7348261,1837066
7702,r175,"United States<sup>b</sup> -> Louisiana -> Wildlife and Fisheries, Department of",United States<sup>b</sup>,Louisiana,"Wildlife and Fisheries, Department of",3,5858469,4347706,1510763
7702,r176,United States<sup>b</sup> -> Maine,United States<sup>b</sup>,Maine,,2,32392463,12263843,20128620
7702,r177,"United States<sup>b</sup> -> Maine -> Agriculture, Conservation and Forestry, Department of ",United States<sup>b</sup>,Maine,"Agriculture, Conservation and Forestry, Department of ",3,1505860,581000,924860
7702,r178,"United States<sup>b</sup> -> Maine -> Inland Fisheries and Wildlife, Department of",United States<sup>b</sup>,Maine,"Inland Fisheries and Wildlife, Department of",3,1080841,847899,232942
7702,r179,"United States<sup>b</sup> -> Maine -> Marine Resources, Department of",United States<sup>b</sup>,Maine,"Marine Resources, Department of",3,2582000,2061000,521000
7702,r180,"United States<sup>b</sup> -> Maine -> MDI Biological Laboratory, Center for Biomedical Innovation",United States<sup>b</sup>,Maine,"MDI Biological Laboratory, Center for Biomedical Innovation",3,8048966,7573944,475022
7702,r181,United States<sup>b</sup> -> Maine -> Technology Institute,United States<sup>b</sup>,Maine,Technology Institute,3,17674796,0,17674796
7702,r182,"United States<sup>b</sup> -> Maine -> Transportation, Department of ",United States<sup>b</sup>,Maine,"Transportation, Department of ",3,1500000,1200000,300000
7702,r183,United States<sup>b</sup> -> Maryland,United States<sup>b</sup>,Maryland,,2,28212493,2005962,26206531
7702,r184,"United States<sup>b</sup> -> Maryland -> Health, Department of",United States<sup>b</sup>,Maryland,"Health, Department of",3,13500000,0,13500000
7702,r185,"United States<sup>b</sup> -> Maryland -> Natural Resources, Department of",United States<sup>b</sup>,Maryland,"Natural Resources, Department of",3,900754,237542,663212
7702,r186,United States<sup>b</sup> -> Maryland -> Technology Development Corporation,United States<sup>b</sup>,Maryland,Technology Development Corporation,3,11600000,0,11600000
7702,r187,"United States<sup>b</sup> -> Maryland -> Transportation, Department of",United States<sup>b</sup>,Maryland,"Transportation, Department of",3,2211739,1768420,443319
7702,r188,United States<sup>b</sup> -> Massachusetts,United States<sup>b</sup>,Massachusetts,,2,23307621,6047993,17259628
7702,r189,United States<sup>b</sup> -> Massachusetts -> Clean Energy Technology Center,United States<sup>b</sup>,Massachusetts,Clean Energy Technology Center,3,5044038,0,5044038
7702,r190,"United States<sup>b</sup> -> Massachusetts -> Environmental Protection, Department of ",United States<sup>b</sup>,Massachusetts,"Environmental Protection, Department of ",3,1771575,22369,1749206
7702,r191,"United States<sup>b</sup> -> Massachusetts -> Fish and Game, Department of ",United States<sup>b</sup>,Massachusetts,"Fish and Game, Department of ",3,915233,624680,290553
7702,r192,United States<sup>b</sup> -> Massachusetts -> Gaming Commission,United States<sup>b</sup>,Massachusetts,Gaming Commission,3,1480178,0,1480178
7702,r193,United States<sup>b</sup> -> Massachusetts -> Life Sciences Center,United States<sup>b</sup>,Massachusetts,Life Sciences Center,3,556868,0,556868
7702,r194,United States<sup>b</sup> -> Massachusetts -> Massventures,United States<sup>b</sup>,Massachusetts,Massventures,3,3942167,0,3942167
7702,r195,"United States<sup>b</sup> -> Massachusetts -> Mental Health, Department of",United States<sup>b</sup>,Massachusetts,"Mental Health, Department of",3,2579520,222362,2357158
7702,r196,"United States<sup>b</sup> -> Massachusetts -> Public Health, Department of ",United States<sup>b</sup>,Massachusetts,"Public Health, Department of ",3,1674277,1386798,287479
7702,r197,United States<sup>b</sup> -> Massachusetts -> Technology Park Corporation ,United States<sup>b</sup>,Massachusetts,Technology Park Corporation ,3,1176748,608078,568670
7702,r198,"United States<sup>b</sup> -> Massachusetts -> Transportation, Department of",United States<sup>b</sup>,Massachusetts,"Transportation, Department of",3,3767017,3183706,583311
7702,r199,United States<sup>b</sup> -> Massachusetts -> Water Resources Authority,United States<sup>b</sup>,Massachusetts,Water Resources Authority,3,400000,0,400000
7702,r200,United States<sup>b</sup> -> Michigan,United States<sup>b</sup>,Michigan,,2,29718391,6912826,22805565
7702,r201,"United States<sup>b</sup> -> Michigan -> Agriculture and Rural Development, Department of",United States<sup>b</sup>,Michigan,"Agriculture and Rural Development, Department of",3,1656683,586830,1069853
7702,r202,"United States<sup>b</sup> -> Michigan -> Environmental, Great Lakes, and Energy, Department of",United States<sup>b</sup>,Michigan,"Environmental, Great Lakes, and Energy, Department of",3,1249610,387235,862375
7702,r203,United States<sup>b</sup> -> Michigan -> Licensing and Regulatory Affairs,United States<sup>b</sup>,Michigan,Licensing and Regulatory Affairs,3,20000000,0,20000000
7702,r204,"United States<sup>b</sup> -> Michigan -> Transportation, Department of",United States<sup>b</sup>,Michigan,"Transportation, Department of",3,6812098,5938761,873337
7702,r205,United States<sup>b</sup> -> Minnesota,United States<sup>b</sup>,Minnesota,,2,22483420,7689513,14793907
7702,r206,"United States<sup>b</sup> -> Minnesota -> Agriculture, Department of",United States<sup>b</sup>,Minnesota,"Agriculture, Department of",3,5408623,700652,4707971
7702,r207,"United States<sup>b</sup> -> Minnesota -> Midwest Dairy Association, Minnesota Division",United States<sup>b</sup>,Minnesota,"Midwest Dairy Association, Minnesota Division",3,213400,0,213400
7702,r208,"United States<sup>b</sup> -> Minnesota -> Natural Resources, Department of",United States<sup>b</sup>,Minnesota,"Natural Resources, Department of",3,1855011,1224022,630989
7702,r209,United States<sup>b</sup> -> Minnesota -> Pollution Control Agency,United States<sup>b</sup>,Minnesota,Pollution Control Agency,3,9888,0,9888
7702,r210,"United States<sup>b</sup> -> Minnesota -> Transportation, Department of",United States<sup>b</sup>,Minnesota,"Transportation, Department of",3,14996498,5764839,9231659
7702,r211,United States<sup>b</sup> -> Mississippi,United States<sup>b</sup>,Mississippi,,2,11143362,9061908,2081454
7702,r212,"United States<sup>b</sup> -> Mississippi -> Agriculture and Commerce, Department of ",United States<sup>b</sup>,Mississippi,"Agriculture and Commerce, Department of ",3,152264,152264,0
7702,r213,"United States<sup>b</sup> -> Mississippi -> Environmental Quality, Department of",United States<sup>b</sup>,Mississippi,"Environmental Quality, Department of",3,1267345,1267345,0
7702,r214,United States<sup>b</sup> -> Mississippi -> Gulf States Marine Fisheries Commission,United States<sup>b</sup>,Mississippi,Gulf States Marine Fisheries Commission,3,1527915,1527915,0
7702,r215,"United States<sup>b</sup> -> Mississippi -> Marine Resources, Department of",United States<sup>b</sup>,Mississippi,"Marine Resources, Department of",3,1110829,164760,946069
7702,r216,"United States<sup>b</sup> -> Mississippi -> Transportation, Department of",United States<sup>b</sup>,Mississippi,"Transportation, Department of",3,5542522,4869891,672631
7702,r217,"United States<sup>b</sup> -> Mississippi -> Wildlife, Fisheries, and Parks, Department of ",United States<sup>b</sup>,Mississippi,"Wildlife, Fisheries, and Parks, Department of ",3,1542487,1079733,462754
7702,r218,United States<sup>b</sup> -> Missouri,United States<sup>b</sup>,Missouri,,2,14009154,4240386,9768768
7702,r219,"United States<sup>b</sup> -> Missouri -> Agriculture, Department of",United States<sup>b</sup>,Missouri,"Agriculture, Department of",3,273268,224768,48500
7702,r220,"United States<sup>b</sup> -> Missouri -> Conservation, Department of",United States<sup>b</sup>,Missouri,"Conservation, Department of",3,9627125,2077905,7549220
7702,r221,"United States<sup>b</sup> -> Missouri -> Mental Health, Department of",United States<sup>b</sup>,Missouri,"Mental Health, Department of",3,242500,0,242500
7702,r222,"United States<sup>b</sup> -> Missouri -> Natural Resources, Department of",United States<sup>b</sup>,Missouri,"Natural Resources, Department of",3,453962,87260,366702
7702,r223,United States<sup>b</sup> -> Missouri -> Technology Corporation,United States<sup>b</sup>,Missouri,Technology Corporation,3,654232,200000,454232
7702,r224,"United States<sup>b</sup> -> Missouri -> Transportation, Department of",United States<sup>b</sup>,Missouri,"Transportation, Department of",3,2120015,1650453,469562
7702,r225,United States<sup>b</sup> -> Missouri -> Wine and Grape Board,United States<sup>b</sup>,Missouri,Wine and Grape Board,3,638052,0,638052
7702,r226,United States<sup>b</sup> -> Montana,United States<sup>b</sup>,Montana,,2,8447295,5600354,2846941
7702,r227,"United States<sup>b</sup> -> Montana -> Agriculture, Department of",United States<sup>b</sup>,Montana,"Agriculture, Department of",3,2841089,1215922,1625167
7702,r228,"United States<sup>b</sup> -> Montana -> Environmental Quality, Department of",United States<sup>b</sup>,Montana,"Environmental Quality, Department of",3,50304,9304,41000
7702,r229,"United States<sup>b</sup> -> Montana -> Fish, Wildlife and Parks, Department of",United States<sup>b</sup>,Montana,"Fish, Wildlife and Parks, Department of",3,3806115,3103574,702541
7702,r230,"United States<sup>b</sup> -> Montana -> Natural Resources and Conservation, Department of",United States<sup>b</sup>,Montana,"Natural Resources and Conservation, Department of",3,16865,0,16865
7702,r231,"United States<sup>b</sup> -> Montana -> Transportation, Department of",United States<sup>b</sup>,Montana,"Transportation, Department of",3,1732922,1271554,461368
7702,r232,United States<sup>b</sup> -> Nebraska,United States<sup>b</sup>,Nebraska,,2,31337947,6288269,25049678
7702,r233,"United States<sup>b</sup> -> Nebraska -> Agriculture, Department of",United States<sup>b</sup>,Nebraska,"Agriculture, Department of",3,797149,702231,94918
7702,r234,United States<sup>b</sup> -> Nebraska -> Corn Board,United States<sup>b</sup>,Nebraska,Corn Board,3,1201594,0,1201594
7702,r235,United States<sup>b</sup> -> Nebraska -> Dry Bean Commission,United States<sup>b</sup>,Nebraska,Dry Bean Commission,3,265487,0,265487
7702,r236,"United States<sup>b</sup> -> Nebraska -> Economic Development, Department of",United States<sup>b</sup>,Nebraska,"Economic Development, Department of",3,3242710,0,3242710
7702,r237,United States<sup>b</sup> -> Nebraska -> Game and Parks Commission,United States<sup>b</sup>,Nebraska,Game and Parks Commission,3,5125851,4198454,927397
7702,r238,United States<sup>b</sup> -> Nebraska -> Grain Sorghum Board,United States<sup>b</sup>,Nebraska,Grain Sorghum Board,3,3000,0,3000
7702,r239,"United States<sup>b</sup> -> Nebraska -> Health and Human Services, Department of",United States<sup>b</sup>,Nebraska,"Health and Human Services, Department of",3,18564076,0,18564076
7702,r240,"United States<sup>b</sup> -> Nebraska -> Midwest Dairy Association, Nebraska Division",United States<sup>b</sup>,Nebraska,"Midwest Dairy Association, Nebraska Division",3,29100,0,29100
7702,r241,"United States<sup>b</sup> -> Nebraska -> Natural Resources, Department of",United States<sup>b</sup>,Nebraska,"Natural Resources, Department of",3,50000,0,50000
7702,r242,"United States<sup>b</sup> -> Nebraska -> Transportation, Department of",United States<sup>b</sup>,Nebraska,"Transportation, Department of",3,1825480,1387584,437896
7702,r243,United States<sup>b</sup> -> Nebraska -> Wheat Board,United States<sup>b</sup>,Nebraska,Wheat Board,3,233500,0,233500
7702,r244,United States<sup>b</sup> -> Nevada,United States<sup>b</sup>,Nevada,,2,4222929,2001509,2221420
7702,r245,"United States<sup>b</sup> -> Nevada -> Agriculture, Department of",United States<sup>b</sup>,Nevada,"Agriculture, Department of",3,237064,177064,60000
7702,r246,"United States<sup>b</sup> -> Nevada -> Economic Development, Governor's office of",United States<sup>b</sup>,Nevada,"Economic Development, Governor's office of",3,1958195,0,1958195
7702,r247,"United States<sup>b</sup> -> Nevada -> Transportation, Department of",United States<sup>b</sup>,Nevada,"Transportation, Department of",3,2027670,1824445,203225
7702,r248,United States<sup>b</sup> -> New Hampshire,United States<sup>b</sup>,New Hampshire,,2,8675207,631502,8043705
7702,r249,"United States<sup>b</sup> -> New Hampshire -> Agriculture, Markets and Food, Department of",United States<sup>b</sup>,New Hampshire,"Agriculture, Markets and Food, Department of",3,175563,56536,119027
7702,r250,"United States<sup>b</sup> -> New Hampshire -> Business and Economic Affairs, Department of",United States<sup>b</sup>,New Hampshire,"Business and Economic Affairs, Department of",3,7275000,0,7275000
7702,r251,"United States<sup>b</sup> -> New Hampshire -> Environmental Services, Department of",United States<sup>b</sup>,New Hampshire,"Environmental Services, Department of",3,505937,0,505937
7702,r252,"United States<sup>b</sup> -> New Hampshire -> Transportation, Department of",United States<sup>b</sup>,New Hampshire,"Transportation, Department of",3,718707,574966,143741
7702,r253,United States<sup>b</sup> -> New Jersey,United States<sup>b</sup>,New Jersey,,2,12864404,5466394,7398010
7702,r254,"United States<sup>b</sup> -> New Jersey -> Children and Families, Department of",United States<sup>b</sup>,New Jersey,"Children and Families, Department of",3,250627,8540,242087
7702,r255,"United States<sup>b</sup> -> New Jersey -> Community Affairs, Department of ",United States<sup>b</sup>,New Jersey,"Community Affairs, Department of ",3,5000,0,5000
7702,r256,"United States<sup>b</sup> -> New Jersey -> Corrections, Department of",United States<sup>b</sup>,New Jersey,"Corrections, Department of",3,309449,0,309449
7702,r257,"United States<sup>b</sup> -> New Jersey -> Environmental Protection, Department of",United States<sup>b</sup>,New Jersey,"Environmental Protection, Department of",3,3398000,373000,3025000
7702,r258,"United States<sup>b</sup> -> New Jersey -> Health, Department of",United States<sup>b</sup>,New Jersey,"Health, Department of",3,318305,0,318305
7702,r259,United States<sup>b</sup> -> New Jersey -> Pinelands Commission,United States<sup>b</sup>,New Jersey,Pinelands Commission,3,576457,517457,59000
7702,r260,"United States<sup>b</sup> -> New Jersey -> Secretary of Higher Education, Office of",United States<sup>b</sup>,New Jersey,"Secretary of Higher Education, Office of",3,2500000,0,2500000
7702,r261,"United States<sup>b</sup> -> New Jersey -> State Parole Board, New Jersey",United States<sup>b</sup>,New Jersey,"State Parole Board, New Jersey",3,66212,29769,36443
7702,r262,"United States<sup>b</sup> -> New Jersey -> Transit, New Jersey",United States<sup>b</sup>,New Jersey,"Transit, New Jersey",3,61804,0,61804
7702,r263,"United States<sup>b</sup> -> New Jersey -> Transportation, Department of",United States<sup>b</sup>,New Jersey,"Transportation, Department of",3,5378550,4537628,840922
7702,r264,United States<sup>b</sup> -> New Mexico,United States<sup>b</sup>,New Mexico,,2,3054817,2152671,902146
7702,r265,"United States<sup>b</sup> -> New Mexico -> Cultural Affairs, Department of",United States<sup>b</sup>,New Mexico,"Cultural Affairs, Department of",3,108053,0,108053
7702,r266,"United States<sup>b</sup> -> New Mexico -> Game and Fish, Department of",United States<sup>b</sup>,New Mexico,"Game and Fish, Department of",3,1000000,500000,500000
7702,r267,"United States<sup>b</sup> -> New Mexico -> Transportation, Department of",United States<sup>b</sup>,New Mexico,"Transportation, Department of",3,1586466,1449219,137247
7702,r268,United States<sup>b</sup> -> New Mexico -> Western State Air Resources Council,United States<sup>b</sup>,New Mexico,Western State Air Resources Council,3,360298,203452,156846
7702,r269,United States<sup>b</sup> -> New York,United States<sup>b</sup>,New York,,2,417246309,166507446,250738863
7702,r270,"United States<sup>b</sup> -> New York -> Agriculture and Markets, Department of ",United States<sup>b</sup>,New York,"Agriculture and Markets, Department of ",3,7194600,2844600,4350000
7702,r271,"United States<sup>b</sup> -> New York -> Economic Development, Department of",United States<sup>b</sup>,New York,"Economic Development, Department of",3,27738133,0,27738133
7702,r272,United States<sup>b</sup> -> New York -> Energy Research and Development Authority,United States<sup>b</sup>,New York,Energy Research and Development Authority,3,58220185,0,58220185
7702,r273,"United States<sup>b</sup> -> New York -> Environmental Conservation, Department of ",United States<sup>b</sup>,New York,"Environmental Conservation, Department of ",3,11777525,1853286,9924239
7702,r274,"United States<sup>b</sup> -> New York -> Health, Department of ",United States<sup>b</sup>,New York,"Health, Department of ",3,65094944,21560131,43534813
7702,r275,"United States<sup>b</sup> -> New York -> Mental Health, Office of ",United States<sup>b</sup>,New York,"Mental Health, Office of ",3,151456861,87115415,64341446
7702,r276,"United States<sup>b</sup> -> New York -> People with Developmental Disabilities, Office of",United States<sup>b</sup>,New York,"People with Developmental Disabilities, Office of",3,1614170,1468008,146162
7702,r277,United States<sup>b</sup> -> New York -> Power Authority,United States<sup>b</sup>,New York,Power Authority,3,14544465,0,14544465
7702,r278,United States<sup>b</sup> -> New York -> Roswell Park Comprehensive Cancer Center,United States<sup>b</sup>,New York,Roswell Park Comprehensive Cancer Center,3,63867651,46823504,17044147
7702,r279,United States<sup>b</sup> -> New York -> State Museum,United States<sup>b</sup>,New York,State Museum,3,10297627,418065,9879562
7702,r280,United States<sup>b</sup> -> New York -> Thoroughbred Breeding and Development Fund Corp.,United States<sup>b</sup>,New York,Thoroughbred Breeding and Development Fund Corp.,3,399308,0,399308
7702,r281,"United States<sup>b</sup> -> New York -> Transportation, Department of ",United States<sup>b</sup>,New York,"Transportation, Department of ",3,5040840,4424437,616403
7702,r282,United States<sup>b</sup> -> North Carolina,United States<sup>b</sup>,North Carolina,,2,36870713,11005615,25865098
7702,r283,"United States<sup>b</sup> -> North Carolina -> Agriculture and Consumer Services, Department of",United States<sup>b</sup>,North Carolina,"Agriculture and Consumer Services, Department of",3,15422911,0,15422911
7702,r284,United States<sup>b</sup> -> North Carolina -> Biotechnology Center,United States<sup>b</sup>,North Carolina,Biotechnology Center,3,2693795,0,2693795
7702,r285,"United States<sup>b</sup> -> North Carolina -> Environmental Quality, Department of",United States<sup>b</sup>,North Carolina,"Environmental Quality, Department of",3,3275158,1288170,1986988
7702,r286,"United States<sup>b</sup> -> North Carolina -> Natural and Cultural Resources, Department of",United States<sup>b</sup>,North Carolina,"Natural and Cultural Resources, Department of",3,1951431,0,1951431
7702,r287,"United States<sup>b</sup> -> North Carolina -> Science Technology & Innovation, Office of",United States<sup>b</sup>,North Carolina,"Science Technology & Innovation, Office of",3,1500000,0,1500000
7702,r288,"United States<sup>b</sup> -> North Carolina -> Transportation, Department of",United States<sup>b</sup>,North Carolina,"Transportation, Department of",3,11886050,9717445,2168605
7702,r289,United States<sup>b</sup> -> North Carolina -> Wine and Grape Growers Council,United States<sup>b</sup>,North Carolina,Wine and Grape Growers Council,3,141368,0,141368
7702,r290,United States<sup>b</sup> -> North Dakota,United States<sup>b</sup>,North Dakota,,2,35139613,6863870,28275743
7702,r291,"United States<sup>b</sup> -> North Dakota -> Agriculture, Department of",United States<sup>b</sup>,North Dakota,"Agriculture, Department of",3,5360395,4990802,369593
7702,r292,United States<sup>b</sup> -> North Dakota -> Dry Pea and Lentil Commission,United States<sup>b</sup>,North Dakota,Dry Pea and Lentil Commission,3,253958,0,253958
7702,r293,"United States<sup>b</sup> -> North Dakota -> Game and Fish, Department of",United States<sup>b</sup>,North Dakota,"Game and Fish, Department of",3,900314,719787,180527
7702,r294,United States<sup>b</sup> -> North Dakota -> Historical Society of North Dakota,United States<sup>b</sup>,North Dakota,Historical Society of North Dakota,3,247149,81615,165534
7702,r295,United States<sup>b</sup> -> North Dakota -> Industrial Commission,United States<sup>b</sup>,North Dakota,Industrial Commission,3,24409679,0,24409679
7702,r296,"United States<sup>b</sup> -> North Dakota -> Midwest Dairy Association, North Dakota Division",United States<sup>b</sup>,North Dakota,"Midwest Dairy Association, North Dakota Division",3,4850,0,4850
7702,r297,United States<sup>b</sup> -> North Dakota -> Soybean Council,United States<sup>b</sup>,North Dakota,Soybean Council,3,1420538,0,1420538
7702,r298,"United States<sup>b</sup> -> North Dakota -> Transportation, Department of",United States<sup>b</sup>,North Dakota,"Transportation, Department of",3,1204774,1071666,133108
7702,r299,United States<sup>b</sup> -> North Dakota -> Wheat Commission,United States<sup>b</sup>,North Dakota,Wheat Commission,3,1337956,0,1337956
7702,r300,United States<sup>b</sup> -> Ohio,United States<sup>b</sup>,Ohio,,2,55336431,8732356,46604075
7702,r301,"United States<sup>b</sup> -> Ohio -> Development, Department of",United States<sup>b</sup>,Ohio,"Development, Department of",3,43878812,0,43878812
7702,r302,"United States<sup>b</sup> -> Ohio -> Education, Department of",United States<sup>b</sup>,Ohio,"Education, Department of",3,230700,215700,15000
7702,r303,"United States<sup>b</sup> -> Ohio -> Mental Health and Addictions Services, Department of",United States<sup>b</sup>,Ohio,"Mental Health and Addictions Services, Department of",3,2060000,2000000,60000
7702,r304,"United States<sup>b</sup> -> Ohio -> Natural Resources, Department of",United States<sup>b</sup>,Ohio,"Natural Resources, Department of",3,2565498,1522100,1043398
7702,r305,United States<sup>b</sup> -> Ohio -> Rail Development Commission,United States<sup>b</sup>,Ohio,Rail Development Commission,3,79156,0,79156
7702,r306,"United States<sup>b</sup> -> Ohio -> Transportation, Department of",United States<sup>b</sup>,Ohio,"Transportation, Department of",3,6197692,4994556,1203136
7702,r307,United States<sup>b</sup> -> Ohio -> Water Development Authority,United States<sup>b</sup>,Ohio,Water Development Authority,3,324573,0,324573
7702,r308,United States<sup>b</sup> -> Oklahoma,United States<sup>b</sup>,Oklahoma,,2,55989692,7560791,48428901
7702,r309,"United States<sup>b</sup> -> Oklahoma -> Advancement of Science and Technology, Center for the ",United States<sup>b</sup>,Oklahoma,"Advancement of Science and Technology, Center for the ",3,34830643,0,34830643
7702,r310,"United States<sup>b</sup> -> Oklahoma -> Agriculture, Food, and Forestry, Department of",United States<sup>b</sup>,Oklahoma,"Agriculture, Food, and Forestry, Department of",3,327515,327515,0
7702,r311,"United States<sup>b</sup> -> Oklahoma -> Environmental Quality, Department of",United States<sup>b</sup>,Oklahoma,"Environmental Quality, Department of",3,217645,207380,10265
7702,r312,United States<sup>b</sup> -> Oklahoma -> Grand River Dam Authority,United States<sup>b</sup>,Oklahoma,Grand River Dam Authority,3,525000,0,525000
7702,r313,"United States<sup>b</sup> -> Oklahoma -> Health, Department of",United States<sup>b</sup>,Oklahoma,"Health, Department of",3,1344978,1324978,20000
7702,r314,"United States<sup>b</sup> -> Oklahoma -> Human Services, Department of",United States<sup>b</sup>,Oklahoma,"Human Services, Department of",3,566539,466122,100417
7702,r315,"United States<sup>b</sup> -> Oklahoma -> Midwest Dairy Association, Oklahoma Division",United States<sup>b</sup>,Oklahoma,"Midwest Dairy Association, Oklahoma Division",3,4850,0,4850
7702,r316,United States<sup>b</sup> -> Oklahoma -> Tobacco Settlement Endowment Trust,United States<sup>b</sup>,Oklahoma,Tobacco Settlement Endowment Trust,3,11931000,0,11931000
7702,r317,"United States<sup>b</sup> -> Oklahoma -> Transportation, Department of",United States<sup>b</sup>,Oklahoma,"Transportation, Department of",3,4692262,3753809,938453
7702,r318,"United States<sup>b</sup> -> Oklahoma -> Wildlife Conservation, Department of",United States<sup>b</sup>,Oklahoma,"Wildlife Conservation, Department of",3,1549260,1480987,68273
7702,r319,United States<sup>b</sup> -> Oregon,United States<sup>b</sup>,Oregon,,2,37419218,14233548,23185670
7702,r320,"United States<sup>b</sup> -> Oregon -> Agriculture, Department of",United States<sup>b</sup>,Oregon,"Agriculture, Department of",3,205647,0,205647
7702,r321,United States<sup>b</sup> -> Oregon -> Business Oregon,United States<sup>b</sup>,Oregon,Business Oregon,3,14300000,0,14300000
7702,r322,"United States<sup>b</sup> -> Oregon -> Fish and Wildlife, Department of",United States<sup>b</sup>,Oregon,"Fish and Wildlife, Department of",3,12566339,9095199,3471140
7702,r323,"United States<sup>b</sup> -> Oregon -> Forestry, Department of",United States<sup>b</sup>,Oregon,"Forestry, Department of",3,700000,0,700000
7702,r324,"United States<sup>b</sup> -> Oregon -> Geology and Mineral Industries, Department of",United States<sup>b</sup>,Oregon,"Geology and Mineral Industries, Department of",3,1210168,1210168,0
7702,r325,"United States<sup>b</sup> -> Oregon -> Human Services, Department of",United States<sup>b</sup>,Oregon,"Human Services, Department of",3,2185495,932330,1253165
7702,r326,"United States<sup>b</sup> -> Oregon -> Transportation, Department of",United States<sup>b</sup>,Oregon,"Transportation, Department of",3,3638363,2992484,645879
7702,r327,United States<sup>b</sup> -> Oregon -> Water Resources Department,United States<sup>b</sup>,Oregon,Water Resources Department,3,1551042,0,1551042
7702,r328,United States<sup>b</sup> -> Oregon -> Watershed Enhancement Board,United States<sup>b</sup>,Oregon,Watershed Enhancement Board,3,1062164,3367,1058797
7702,r329,United States<sup>b</sup> -> Pennsylvania,United States<sup>b</sup>,Pennsylvania,,2,93621093,10315593,83305500
7702,r330,"United States<sup>b</sup> -> Pennsylvania -> Agriculture, Department of",United States<sup>b</sup>,Pennsylvania,"Agriculture, Department of",3,2461164,274164,2187000
7702,r331,"United States<sup>b</sup> -> Pennsylvania -> Community and Economic Development, Department of",United States<sup>b</sup>,Pennsylvania,"Community and Economic Development, Department of",3,21500000,0,21500000
7702,r332,"United States<sup>b</sup> -> Pennsylvania -> Conservation and Natural Resources, Department of",United States<sup>b</sup>,Pennsylvania,"Conservation and Natural Resources, Department of",3,309471,0,309471
7702,r333,"United States<sup>b</sup> -> Pennsylvania -> Environmental Protection, Department of",United States<sup>b</sup>,Pennsylvania,"Environmental Protection, Department of",3,1931821,278352,1653469
7702,r334,United States<sup>b</sup> -> Pennsylvania -> Fish and Boat Commission,United States<sup>b</sup>,Pennsylvania,Fish and Boat Commission,3,259114,106143,152971
7702,r335,United States<sup>b</sup> -> Pennsylvania -> Game Commission,United States<sup>b</sup>,Pennsylvania,Game Commission,3,7513056,5057881,2455175
7702,r336,"United States<sup>b</sup> -> Pennsylvania -> Health, Department of",United States<sup>b</sup>,Pennsylvania,"Health, Department of",3,55000914,0,55000914
7702,r337,United States<sup>b</sup> -> Pennsylvania -> Susquehanna River Basin Commission,United States<sup>b</sup>,Pennsylvania,Susquehanna River Basin Commission,3,279000,232500,46500
7702,r338,"United States<sup>b</sup> -> Pennsylvania -> Transportation, Department of",United States<sup>b</sup>,Pennsylvania,"Transportation, Department of",3,4366553,4366553,0
7702,r339,United States<sup>b</sup> -> Rhode Island,United States<sup>b</sup>,Rhode Island,,2,10226630,6631735,3594895
7702,r340,United States<sup>b</sup> -> Rhode Island -> Commerce Corporation,United States<sup>b</sup>,Rhode Island,Commerce Corporation,3,1127624,0,1127624
7702,r341,"United States<sup>b</sup> -> Rhode Island -> Fish and Wildlife; Environmental Management, Department of",United States<sup>b</sup>,Rhode Island,"Fish and Wildlife; Environmental Management, Department of",3,5238690,4137805,1100885
7702,r342,"United States<sup>b</sup> -> Rhode Island -> Marine Fisheries; Environmental Management, Department of",United States<sup>b</sup>,Rhode Island,"Marine Fisheries; Environmental Management, Department of",3,3601968,2303231,1298737
7702,r343,"United States<sup>b</sup> -> Rhode Island -> Narragansett Bay National Estuarine Research Reserve; Environmental Management, Department of",United States<sup>b</sup>,Rhode Island,"Narragansett Bay National Estuarine Research Reserve; Environmental Management, Department of",3,67378,60830,6548
7702,r344,"United States<sup>b</sup> -> Rhode Island -> Transportation, Department of",United States<sup>b</sup>,Rhode Island,"Transportation, Department of",3,87500,70000,17500
7702,r345,United States<sup>b</sup> -> Rhode Island -> Water Resources Board,United States<sup>b</sup>,Rhode Island,Water Resources Board,3,103470,59869,43601
7702,r346,United States<sup>b</sup> -> South Carolina,United States<sup>b</sup>,South Carolina,,2,44557581,27721413,16836168
7702,r347,"United States<sup>b</sup> -> South Carolina -> Agriculture, Department of",United States<sup>b</sup>,South Carolina,"Agriculture, Department of",3,1119867,248039,871828
7702,r348,"United States<sup>b</sup> -> South Carolina -> Disabilities and Special Needs, Department of",United States<sup>b</sup>,South Carolina,"Disabilities and Special Needs, Department of",3,9437880,4903580,4534300
7702,r349,"United States<sup>b</sup> -> South Carolina -> Health and Environmental Control, Department of",United States<sup>b</sup>,South Carolina,"Health and Environmental Control, Department of",3,1314349,1314349,0
7702,r350,"United States<sup>b</sup> -> South Carolina -> Mental Health, Department of",United States<sup>b</sup>,South Carolina,"Mental Health, Department of",3,53424,0,53424
7702,r351,"United States<sup>b</sup> -> South Carolina -> Natural Resources, Department of",United States<sup>b</sup>,South Carolina,"Natural Resources, Department of",3,24893262,17414642,7478620
7702,r352,United States<sup>b</sup> -> South Carolina -> Public Service Authority,United States<sup>b</sup>,South Carolina,Public Service Authority,3,424350,0,424350
7702,r353,United States<sup>b</sup> -> South Carolina -> Research Authority,United States<sup>b</sup>,South Carolina,Research Authority,3,2339441,116361,2223080
7702,r354,United States<sup>b</sup> -> South Carolina -> Sea Grant Consortium,United States<sup>b</sup>,South Carolina,Sea Grant Consortium,3,2328658,1613370,715288
7702,r355,"United States<sup>b</sup> -> South Carolina -> Transportation, Department of",United States<sup>b</sup>,South Carolina,"Transportation, Department of",3,2646350,2111072,535278
7702,r356,United States<sup>b</sup> -> South Dakota,United States<sup>b</sup>,South Dakota,,2,3193289,725396,2467893
7702,r357,United States<sup>b</sup> -> South Dakota -> Corn Utilization Council,United States<sup>b</sup>,South Dakota,Corn Utilization Council,3,150006,0,150006
7702,r358,"United States<sup>b</sup> -> South Dakota -> Midwest Dairy Association, South Dakota Division",United States<sup>b</sup>,South Dakota,"Midwest Dairy Association, South Dakota Division",3,63050,0,63050
7702,r359,United States<sup>b</sup> -> South Dakota -> Nutrient Research and Education Council,United States<sup>b</sup>,South Dakota,Nutrient Research and Education Council,3,871090,0,871090
7702,r360,United States<sup>b</sup> -> South Dakota -> Oilseeds Council,United States<sup>b</sup>,South Dakota,Oilseeds Council,3,278954,0,278954
7702,r361,United States<sup>b</sup> -> South Dakota -> Pulse Crop Council,United States<sup>b</sup>,South Dakota,Pulse Crop Council,3,4063,0,4063
7702,r362,United States<sup>b</sup> -> South Dakota -> Science and Technology Authority,United States<sup>b</sup>,South Dakota,Science and Technology Authority,3,1968,1968,0
7702,r363,United States<sup>b</sup> -> South Dakota -> Soybean Research and Promotion Council,United States<sup>b</sup>,South Dakota,Soybean Research and Promotion Council,3,342368,0,342368
7702,r364,"United States<sup>b</sup> -> South Dakota -> Transportation, Department of",United States<sup>b</sup>,South Dakota,"Transportation, Department of",3,1178029,723428,454601
7702,r365,United States<sup>b</sup> -> South Dakota -> Weed and Pest Control Commission,United States<sup>b</sup>,South Dakota,Weed and Pest Control Commission,3,43411,0,43411
7702,r366,United States<sup>b</sup> -> South Dakota -> Wheat Commission,United States<sup>b</sup>,South Dakota,Wheat Commission,3,260350,0,260350
7702,r367,United States<sup>b</sup> -> Tennessee,United States<sup>b</sup>,Tennessee,,2,10287206,7551808,2735398
7702,r368,"United States<sup>b</sup> -> Tennessee -> Education, Department of",United States<sup>b</sup>,Tennessee,"Education, Department of",3,3368383,2086399,1281984
7702,r369,"United States<sup>b</sup> -> Tennessee -> Environment and Conservation, Department of",United States<sup>b</sup>,Tennessee,"Environment and Conservation, Department of",3,235156,118476,116680
7702,r370,"United States<sup>b</sup> -> Tennessee -> Transportation, Department of",United States<sup>b</sup>,Tennessee,"Transportation, Department of",3,6683667,5346933,1336734
7702,r371,United States<sup>b</sup> -> Texas,United States<sup>b</sup>,Texas,,2,255731862,23447625,232284237
7702,r372,"United States<sup>b</sup> -> Texas -> Agriculture, Department of",United States<sup>b</sup>,Texas,"Agriculture, Department of",3,932510,932510,0
7702,r373,United States<sup>b</sup> -> Texas -> Alzheimer's Research and Care Consortium (TARCC),United States<sup>b</sup>,Texas,Alzheimer's Research and Care Consortium (TARCC),3,4615313,0,4615313
7702,r374,United States<sup>b</sup> -> Texas -> Cancer Prevention and Research Institute,United States<sup>b</sup>,Texas,Cancer Prevention and Research Institute,3,216766526,0,216766526
7702,r375,"United States<sup>b</sup> -> Texas -> Environmental Quality, Commission on",United States<sup>b</sup>,Texas,"Environmental Quality, Commission on",3,1922455,584503,1337952
7702,r376,United States<sup>b</sup> -> Texas -> Parks and Wildlife Department,United States<sup>b</sup>,Texas,Parks and Wildlife Department,3,6215323,4378230,1837093
7702,r377,"United States<sup>b</sup> -> Texas -> State Health Services, Department of ",United States<sup>b</sup>,Texas,"State Health Services, Department of ",3,1602005,1131209,470796
7702,r378,"United States<sup>b</sup> -> Texas -> Transportation, Department of",United States<sup>b</sup>,Texas,"Transportation, Department of",3,20505965,16421173,4084792
7702,r379,United States<sup>b</sup> -> Texas -> Water Development Board,United States<sup>b</sup>,Texas,Water Development Board,3,3171765,0,3171765
7702,r380,United States<sup>b</sup> -> Utah,United States<sup>b</sup>,Utah,,2,8316189,1701485,6614704
7702,r381,"United States<sup>b</sup> -> Utah -> Environmental Quality, Department of",United States<sup>b</sup>,Utah,"Environmental Quality, Department of",3,780433,0,780433
7702,r382,"United States<sup>b</sup> -> Utah -> Health, Department of",United States<sup>b</sup>,Utah,"Health, Department of",3,5350,150,5200
7702,r383,"United States<sup>b</sup> -> Utah -> Natural Resources, Department of",United States<sup>b</sup>,Utah,"Natural Resources, Department of",3,4215230,0,4215230
7702,r384,"United States<sup>b</sup> -> Utah -> Transportation, Department of ",United States<sup>b</sup>,Utah,"Transportation, Department of ",3,3315176,1701335,1613841
7702,r385,United States<sup>b</sup> -> Vermont,United States<sup>b</sup>,Vermont,,2,1535157,1081618,453539
7702,r386,"United States<sup>b</sup> -> Vermont -> Agriculture, Food, and Markets, Agency of",United States<sup>b</sup>,Vermont,"Agriculture, Food, and Markets, Agency of",3,274477,0,274477
7702,r387,"United States<sup>b</sup> -> Vermont -> Human Services, Agency of",United States<sup>b</sup>,Vermont,"Human Services, Agency of",3,163373,163373,0
7702,r388,"United States<sup>b</sup> -> Vermont -> Transportation, Agency of",United States<sup>b</sup>,Vermont,"Transportation, Agency of",3,1097307,918245,179062
7702,r389,United States<sup>b</sup> -> Virginia,United States<sup>b</sup>,Virginia,,2,44913546,19427277,25486269
7702,r390,"United States<sup>b</sup> -> Virginia -> Aging and Rehabilitative Services, Department of",United States<sup>b</sup>,Virginia,"Aging and Rehabilitative Services, Department of",3,128788,128788,0
7702,r391,"United States<sup>b</sup> -> Virginia -> Agriculture and Consumer Services, Department of",United States<sup>b</sup>,Virginia,"Agriculture and Consumer Services, Department of",3,2821841,913514,1908327
7702,r392,United States<sup>b</sup> -> Virginia -> Commonwealth Health Research Board,United States<sup>b</sup>,Virginia,Commonwealth Health Research Board,3,1566854,0,1566854
7702,r393,"United States<sup>b</sup> -> Virginia -> Conservation and Recreation, Department of",United States<sup>b</sup>,Virginia,"Conservation and Recreation, Department of",3,467900,321195,146705
7702,r394,"United States<sup>b</sup> -> Virginia -> Education, Department of",United States<sup>b</sup>,Virginia,"Education, Department of",3,2495435,2055700,439735
7702,r395,"United States<sup>b</sup> -> Virginia -> Energy, Department of",United States<sup>b</sup>,Virginia,"Energy, Department of",3,1530387,654826,875561
7702,r396,"United States<sup>b</sup> -> Virginia -> Environmental Quality, Department of",United States<sup>b</sup>,Virginia,"Environmental Quality, Department of",3,366645,268504,98141
7702,r397,"United States<sup>b</sup> -> Virginia -> Forensic Science, Department of",United States<sup>b</sup>,Virginia,"Forensic Science, Department of",3,1337377,278628,1058749
7702,r398,"United States<sup>b</sup> -> Virginia -> Forestry, Department of",United States<sup>b</sup>,Virginia,"Forestry, Department of",3,701053,529587,171466
7702,r399,United States<sup>b</sup> -> Virginia -> Foundation for Healthy Youth,United States<sup>b</sup>,Virginia,Foundation for Healthy Youth,3,787149,0,787149
7702,r400,"United States<sup>b</sup> -> Virginia -> Innovative Technology, Center for",United States<sup>b</sup>,Virginia,"Innovative Technology, Center for",3,11596571,3715617,7880954
7702,r401,United States<sup>b</sup> -> Virginia -> Institute for Advanced Learning and Research,United States<sup>b</sup>,Virginia,Institute for Advanced Learning and Research,3,57000,0,57000
7702,r402,United States<sup>b</sup> -> Virginia -> Marine Resources Commission,United States<sup>b</sup>,Virginia,Marine Resources Commission,3,1847815,1620709,227106
7702,r403,"United States<sup>b</sup> -> Virginia -> Natural History, Museum of",United States<sup>b</sup>,Virginia,"Natural History, Museum of",3,900582,0,900582
7702,r404,"United States<sup>b</sup> -> Virginia -> Social Services, Department of",United States<sup>b</sup>,Virginia,"Social Services, Department of",3,800000,400000,400000
7702,r405,"United States<sup>b</sup> -> Virginia -> Transportation, Department of",United States<sup>b</sup>,Virginia,"Transportation, Department of",3,15943293,7652026,8291267
7702,r406,"United States<sup>b</sup> -> Virginia -> Wildlife Resources, Department of",United States<sup>b</sup>,Virginia,"Wildlife Resources, Department of",3,1564856,888183,676673
7702,r407,United States<sup>b</sup> -> Washington,United States<sup>b</sup>,Washington,,2,56690210,17162043,39528167
7702,r408,"United States<sup>b</sup> -> Washington -> Agriculture, Department of",United States<sup>b</sup>,Washington,"Agriculture, Department of",3,3498238,2524381,973857
7702,r409,United States<sup>b</sup> -> Washington -> Alfalfa Seed Commission,United States<sup>b</sup>,Washington,Alfalfa Seed Commission,3,34000,0,34000
7702,r410,"United States<sup>b</sup> -> Washington -> Commerce, Department of",United States<sup>b</sup>,Washington,"Commerce, Department of",3,11485246,0,11485246
7702,r411,United States<sup>b</sup> -> Washington -> Cranberry Commission,United States<sup>b</sup>,Washington,Cranberry Commission,3,16000,0,16000
7702,r412,"United States<sup>b</sup> -> Washington -> Ecology, Department of",United States<sup>b</sup>,Washington,"Ecology, Department of",3,1398475,181987,1216488
7702,r413,"United States<sup>b</sup> -> Washington -> Fish and Wildlife, Department of",United States<sup>b</sup>,Washington,"Fish and Wildlife, Department of",3,11181950,5843117,5338833
7702,r414,United States<sup>b</sup> -> Washington -> Fruit Commission,United States<sup>b</sup>,Washington,Fruit Commission,3,134538,0,134538
7702,r415,United States<sup>b</sup> -> Washington -> Grain Commission,United States<sup>b</sup>,Washington,Grain Commission,3,1860504,0,1860504
7702,r416,"United States<sup>b</sup> -> Washington -> Health, Department of",United States<sup>b</sup>,Washington,"Health, Department of",3,1233000,866000,367000
7702,r417,United States<sup>b</sup> -> Washington -> Hop Commission,United States<sup>b</sup>,Washington,Hop Commission,3,272988,0,272988
7702,r418,"United States<sup>b</sup> -> Washington -> Labor and Industries, Department of",United States<sup>b</sup>,Washington,"Labor and Industries, Department of",3,3408658,662381,2746277
7702,r419,United States<sup>b</sup> -> Washington -> Mint Commission,United States<sup>b</sup>,Washington,Mint Commission,3,27171,0,27171
7702,r420,"United States<sup>b</sup> -> Washington -> Natural Resources, Department of",United States<sup>b</sup>,Washington,"Natural Resources, Department of",3,7587114,570918,7016196
7702,r421,United States<sup>b</sup> -> Washington -> Oilseeds Commission,United States<sup>b</sup>,Washington,Oilseeds Commission,3,46152,0,46152
7702,r422,"United States<sup>b</sup> -> Washington -> Pesticide Registration, Commission on",United States<sup>b</sup>,Washington,"Pesticide Registration, Commission on",3,357969,0,357969
7702,r423,United States<sup>b</sup> -> Washington -> Potato Commission,United States<sup>b</sup>,Washington,Potato Commission,3,837892,0,837892
7702,r424,United States<sup>b</sup> -> Washington -> Puget Sound Partnership,United States<sup>b</sup>,Washington,Puget Sound Partnership,3,850000,0,850000
7702,r425,United States<sup>b</sup> -> Washington -> Pulse Crops Commission,United States<sup>b</sup>,Washington,Pulse Crops Commission,3,238186,0,238186
7702,r426,United States<sup>b</sup> -> Washington -> Red Raspberry Commission,United States<sup>b</sup>,Washington,Red Raspberry Commission,3,220248,52248,168000
7702,r427,United States<sup>b</sup> -> Washington -> Seed Potato Commission,United States<sup>b</sup>,Washington,Seed Potato Commission,3,25639,0,25639
7702,r428,"United States<sup>b</sup> -> Washington -> Transportation, Department of",United States<sup>b</sup>,Washington,"Transportation, Department of",3,7528900,5537600,1991300
7702,r429,United States<sup>b</sup> -> Washington -> Tree Fruit Research Commission,United States<sup>b</sup>,Washington,Tree Fruit Research Commission,3,4096282,923411,3172871
7702,r430,United States<sup>b</sup> -> Washington -> Turfgrass Seed Commission,United States<sup>b</sup>,Washington,Turfgrass Seed Commission,3,107060,0,107060
7702,r431,United States<sup>b</sup> -> Washington -> Wine Commission,United States<sup>b</sup>,Washington,Wine Commission,3,244000,0,244000
7702,r432,United States<sup>b</sup> -> West Virginia,United States<sup>b</sup>,West Virginia,,2,9013091,5247993,3765098
7702,r433,"United States<sup>b</sup> -> West Virginia -> Agriculture, Department of",United States<sup>b</sup>,West Virginia,"Agriculture, Department of",3,166685,166685,0
7702,r434,United States<sup>b</sup> -> West Virginia -> Geological and Economic Survey,United States<sup>b</sup>,West Virginia,Geological and Economic Survey,3,1611208,245035,1366173
7702,r435,United States<sup>b</sup> -> West Virginia -> Higher Education Policy Commission,United States<sup>b</sup>,West Virginia,Higher Education Policy Commission,3,2924776,1588952,1335824
7702,r436,"United States<sup>b</sup> -> West Virginia -> Natural Resources, Department of",United States<sup>b</sup>,West Virginia,"Natural Resources, Department of",3,2052676,1539507,513169
7702,r437,"United States<sup>b</sup> -> West Virginia -> Transportation, Department of",United States<sup>b</sup>,West Virginia,"Transportation, Department of",3,2257746,1707814,549932
7702,r438,United States<sup>b</sup> -> Wisconsin,United States<sup>b</sup>,Wisconsin,,2,15239075,5893866,9345209
7702,r439,"United States<sup>b</sup> -> Wisconsin -> Agriculture, Trade and Consumer Protection, Department of",United States<sup>b</sup>,Wisconsin,"Agriculture, Trade and Consumer Protection, Department of",3,1558082,1287522,270560
7702,r440,United States<sup>b</sup> -> Wisconsin -> Economic Development Corporation,United States<sup>b</sup>,Wisconsin,Economic Development Corporation,3,4625125,0,4625125
7702,r441,"United States<sup>b</sup> -> Wisconsin -> Natural Resources, Department of",United States<sup>b</sup>,Wisconsin,"Natural Resources, Department of",3,6879700,2812900,4066800
7702,r442,"United States<sup>b</sup> -> Wisconsin -> Transportation, Department of",United States<sup>b</sup>,Wisconsin,"Transportation, Department of",3,2176168,1793444,382724
7702,r443,United States<sup>b</sup> -> Wyoming,United States<sup>b</sup>,Wyoming,,2,7278796,3124556,4154240
7702,r444,"United States<sup>b</sup> -> Wyoming -> Agriculture, Department of",United States<sup>b</sup>,Wyoming,"Agriculture, Department of",3,531634,189874,341760
7702,r445,United States<sup>b</sup> -> Wyoming -> Business Council,United States<sup>b</sup>,Wyoming,Business Council,3,1544835,0,1544835
7702,r446,"United States<sup>b</sup> -> Wyoming -> Corrections, Department of",United States<sup>b</sup>,Wyoming,"Corrections, Department of",3,123280,0,123280
7702,r447,United States<sup>b</sup> -> Wyoming -> Energy Authority,United States<sup>b</sup>,Wyoming,Energy Authority,3,413533,0,413533
7702,r448,United States<sup>b</sup> -> Wyoming -> Enhanced Oil Recovery Institute,United States<sup>b</sup>,Wyoming,Enhanced Oil Recovery Institute,3,1126393,492847,633546
7702,r449,United States<sup>b</sup> -> Wyoming -> Game and Fish Department,United States<sup>b</sup>,Wyoming,Game and Fish Department,3,1968341,1390148,578193
7702,r450,United States<sup>b</sup> -> Wyoming -> State Geological Survey,United States<sup>b</sup>,Wyoming,State Geological Survey,3,182179,170334,11845
7702,r451,"United States<sup>b</sup> -> Wyoming -> Transportation, Department of",United States<sup>b</sup>,Wyoming,"Transportation, Department of",3,1105147,881353,223794
7702,r452,United States<sup>b</sup> -> Wyoming -> Water Development Office,United States<sup>b</sup>,Wyoming,Water Development Office,3,283454,0,283454
